------------=MOVE_NONE
DESTRUCTOR=POUND
GOLPE KARATE=KARATE_CHOP
DOBLE BOFETÓN*=DOUBLESLAP
PUÑO COMETA=COMET_PUNCH
MEGAPUÑO=MEGA_PUNCH
DÍA DE PAGO=PAY_DAY
PUÑO FUEGO=FIRE_PUNCH
PUÑO HIELO=ICE_PUNCH
PUÑO TRUENO*=THUNDERPUNCH
ARAÑAZO=SCRATCH
AGARRE=VICEGRIP
GUILLOTINA=GUILLOTINE
VIENTO CORTANTE*=RAZOR_WIND
DANZA ESPADA*=SWORDS_DANCE
CORTE=CUT
TORNADO=GUST
ATAQUE ALA*=WING_ATTACK
REMOLINO=WHIRLWIND
VUELO=FLY
ATADURA=BIND
ATIZAR*=SLAM
LÁTIGO CEPA=VINE_WHIP
PISOTÓN=STOMP
DOBLE PATADA=DOUBLE_KICK
MEGAPATADA=MEGA_KICK
PATADA SALTO=JUMP_KICK
PATADA GIRO=ROLLING_KICK
ATAQUE ARENA*=SAND_ATTACK
GOLPE CABEZA=HEADBUTT
CORNADA=HORN_ATTACK
ATAQUE FURIA=FURY_ATTACK
PERFORADOR=HORN_DRILL
PLACAJE=TACKLE
GOLPE CUERPO=BODY_SLAM
CONSTRICCIÓN*=WRAP
DERRIBO=TAKE_DOWN
SAÑA*=THRASH
DOBLE FILO=DOUBLE_EDGE
LÁTIGO=TAIL_WHIP
PICOTAZO VENENO*=POISON_STING
DOBLE ATAQUE*=TWINEEDLE
PIN MISIL=PIN_MISSILE
MALICIOSO=LEER
MORDISCO=BITE
GRUÑIDO=GROWL
RUGIDO=ROAR
CANTO=SING
SUPERSÓNICO=SUPERSONIC
BOMBA SÓNICA=SONICBOOM
ANULACIÓN=DISABLE
ÁCIDO=ACID
ASCUAS=EMBER
LANZALLAMAS=FLAMETHROWER
NEBLINA=MIST
PISTOLA AGUA=WATER_GUN
HIDROBOMBA=HYDRO_PUMP
SURF=SURF
RAYO HIELO=ICE_BEAM
VENTISCA=BLIZZARD
PSICORRAYO=PSYBEAM
RAYO BURBUJA=BUBBLEBEAM
RAYO AURORA=AURORA_BEAM
HIPERRAYO*=HYPER_BEAM
PICOTAZO=PECK
PICO TALADRO=DRILL_PECK
SUMISIÓN=SUBMISSION
PATADA BAJA=LOW_KICK
CONTRAATAQUE*=COUNTER
SÍSMICO*=SEISMIC_TOSS
FUERZA=STRENGTH
ABSORBER=ABSORB
MEGAAGOTAR=MEGA_DRAIN
DRENADORAS=LEECH_SEED
DESARROLLO=GROWTH
HOJA AFILADA=RAZOR_LEAF
RAYO SOLAR=SOLARBEAM
POLVO VENENO=POISONPOWDER
PARALIZADOR=STUN_SPORE
SOMNÍFERO=SLEEP_POWDER
DANZA PÉTALO=PETAL_DANCE
DISPARO DEMORA*=STRING_SHOT
FURIA DRAGÓN=DRAGON_RAGE
GIRO FUEGO=FIRE_SPIN
IMPACTRUENO=THUNDERSHOCK
RAYO=THUNDERBOLT
ONDA TRUENO=THUNDER_WAVE
TRUENO=THUNDER
LANZARROCAS=ROCK_THROW
TERREMOTO=EARTHQUAKE
FISURA=FISSURE
EXCAVAR=DIG
TÓXICO=TOXIC
CONFUSIÓN=CONFUSION
PSÍQUICO=PSYCHIC
HIPNOSIS=HYPNOSIS
MEDITACIÓN=MEDITATE
AGILIDAD=AGILITY
ATAQUE RÁPIDO**=QUICK_ATTACK
FURIA=RAGE
TELETRANSPORTE*=TELEPORT
TINIEBLAS=NIGHT_SHADE
MIMÉTICO=MIMIC
CHIRRIDO=SCREECH
DOBLE EQUIPO=DOUBLE_TEAM
RECUPERACIÓN=RECOVER
FORTALEZA=HARDEN
REDUCCIÓN=MINIMIZE
PANTALLA DE HUMO*=SMOKESCREEN
RAYO CONFUSO=CONFUSE_RAY
REFUGIO=WITHDRAW
RIZO DEFENSA=DEFENSE_CURL
BARRERA=BARRIER
PANTALLA DE LUZ*=LIGHT_SCREEN
NIEBLA=HAZE
REFLEJO=REFLECT
FOCO ENERGÍA=FOCUS_ENERGY
VENGANZA=BIDE
METRÓNOMO=METRONOME
ESPEJO*=MIRROR_MOVE
AUTODESTRUCCIÓN*=SELFDESTRUCT
BOMBA HUEVO=EGG_BOMB
LENGÜETAZO=LICK
POLUCIÓN=SMOG
RESIDUOS=SLUDGE
HUESO PALO=BONE_CLUB
LLAMARADA=FIRE_BLAST
CASCADA=WATERFALL
TENAZA=CLAMP
METEOROS*=SWIFT
CABEZAZO=SKULL_BASH
CLAVO CAÑÓN=SPIKE_CANNON
RESTRICCIÓN=CONSTRICT
AMNESIA=AMNESIA
KINÉTICO=KINESIS
OVOCURACIÓN*=SOFTBOILED
PAT. SALTO ALTA*=HI_JUMP_KICK
DESLUMBRAR=GLARE
COMESUEÑOS*=DREAM_EATER
GAS VENENOSO=POISON_GAS
BOMBARDEO*=BARRAGE
CHUPAVIDAS=LEECH_LIFE
BESO AMOROSO=LOVELY_KISS
ATAQUE AÉREO=SKY_ATTACK
TRANSFORMACIÓN*=TRANSFORM
BURBUJA=BUBBLE
PUÑO MAREO*=DIZZY_PUNCH
ESPORA=SPORE
DESTELLO=FLASH
PSICOONDA*=PSYWAVE
SALPICADURA=SPLASH
ARMADURA ÁCIDA*=ACID_ARMOR
MARTILLAZO=CRABHAMMER
EXPLOSIÓN=EXPLOSION
GOLPES FURIA=FURY_SWIPES
HUESOMERANG=BONEMERANG
DESCANSO=REST
AVALANCHA=ROCK_SLIDE
HIPERCOLMILLO*=HYPER_FANG
AFILAR=SHARPEN
CONVERSIÓN=CONVERSION
TRIATAQUE*=TRI_ATTACK
SUPERDIENTE=SUPER_FANG
CUCHILLADA=SLASH
SUSTITUTO=SUBSTITUTE
FORCEJEO*=STRUGGLE
ESQUEMA=SKETCH
TRIPLE PATADA*=TRIPLE_KICK
LADRÓN=THIEF
TELARAÑA=SPIDER_WEB
TELÉPATA=MIND_READER
PESADILLA=NIGHTMARE
RUEDA FUEGO=FLAME_WHEEL
RONQUIDO=SNORE
MALDICIÓN=CURSE
AZOTE=FLAIL
CONVERSIÓN2=CONVERSION_2
AEROCHORRO=AEROBLAST
ESPORAGODÓN=COTTON_SPORE
INVERSIÓN=REVERSAL
RENCOR=SPITE
NIEVE POLVO=POWDER_SNOW
PROTECCIÓN=PROTECT
ULTRAPUÑO=MACH_PUNCH
CARA SUSTO=SCARY_FACE
FINTA=FAINT_ATTACK
BESO DULCE=SWEET_KISS
TAMBOR=BELLY_DRUM
BOMBA LODO=SLUDGE_BOMB
BOFETÓN LODO*=MUD_SLAP
PULPOCAÑÓN=OCTAZOOKA
PÚAS=SPIKES
ELECTROCAÑÓN=ZAP_CANNON
PROFECÍA=FORESIGHT
MISMO DESTINO*=DESTINY_BOND
CANTO MORTAL=PERISH_SONG
VIENTO HIELO=ICY_WIND
DETECCIÓN=DETECT
ATAQUE ÓSEO=BONE_RUSH
FIJAR BLANCO=LOCK_ON
ENFADO=OUTRAGE
TORMENTA ARENA*=SANDSTORM
GIGADRENADO*=GIGA_DRAIN
AGUANTE=ENDURE
ENCANTO=CHARM
RODAR*=ROLLOUT
FALSO TORTAZO*=FALSE_SWIPE
CONTONEO=SWAGGER
BATIDO=MILK_DRINK
CHISPA=SPARK
CORTE FURIA*=FURY_CUTTER
ALA DE ACERO=STEEL_WING
MAL DE OJO=MEAN_LOOK
ATRACCIÓN=ATTRACT
SONÁMBULO=SLEEP_TALK
CASCABEL CURA*=HEAL_BELL
RETRIBUCIÓN*=RETURN
PRESENTE=PRESENT
FRUSTRACIÓN=FRUSTRATION
VELO SAGRADO=SAFEGUARD
DIVIDE DOLOR=PAIN_SPLIT
FUEGO SAGRADO*=SACRED_FIRE
MAGNITUD=MAGNITUDE
PUÑO DINÁMICO*=DYNAMICPUNCH
MEGACUERNO=MEGAHORN
DRAGOALIENTO=DRAGONBREATH
RELEVO=BATON_PASS
OTRA VEZ=ENCORE
PERSECUCIÓN=PURSUIT
GIRO RÁPIDO=RAPID_SPIN
DULCE AROMA=SWEET_SCENT
COLA FÉRREA=IRON_TAIL
GARRA METAL*=METAL_CLAW
LLAVE VITAL*=VITAL_THROW
SOL MATINAL=MORNING_SUN
SÍNTESIS=SYNTHESIS
LUZ LUNAR=MOONLIGHT
PODER OCULTO=HIDDEN_POWER
TAJO CRUZADO=CROSS_CHOP
CICLÓN=TWISTER
DANZA LLUVIA=RAIN_DANCE
DÍA SOLEADO=SUNNY_DAY
TRITURAR=CRUNCH
MANTO ESPEJO=MIRROR_COAT
AUTOSUGESTIÓN*=PSYCH_UP
VELOC. EXTREMA*=EXTREMESPEED
PODER PASADO=ANCIENTPOWER
BOLA SOMBRA=SHADOW_BALL
PREMONICIÓN=FUTURE_SIGHT
GOLPE ROCA=ROCK_SMASH
TORBELLINO=WHIRLPOOL
PALIZA=BEAT_UP
SORPRESA=FAKE_OUT
ALBOROTO=UPROAR
RESERVA=STOCKPILE
ESCUPIR=SPIT_UP
TRAGAR=SWALLOW
ONDA ÍGNEA=HEAT_WAVE
GRANIZO=HAIL
TORMENTO=TORMENT
CAMELO=FLATTER
FUEGO FATUO=WILL_O_WISP
LEGADO=MEMENTO
IMAGEN=FACADE
PUÑO CERTERO=FOCUS_PUNCH
ESTÍMULO=SMELLINGSALT
SEÑUELO=FOLLOW_ME
ADAPTACIÓN=NATURE_POWER
CARGA=CHARGE
MOFA=TAUNT
REFUERZO=HELPING_HAND
TRUCO=TRICK
IMITACIÓN=ROLE_PLAY
DESEO=WISH
AYUDA=ASSIST
ARRAIGO=INGRAIN
FUERZA BRUTA=SUPERPOWER
CAPA MÁGICA=MAGIC_COAT
RECICLAJE=RECYCLE
DESQUITE=REVENGE
DEMOLICIÓN=BRICK_BREAK
BOSTEZO=YAWN
DESARME=KNOCK_OFF
ESFUERZO=ENDEAVOR
ESTALLIDO=ERUPTION
INTERCAMBIO=SKILL_SWAP
SELLAR*=IMPRISON
ALIVIO=REFRESH
RABIA=GRUDGE
ROBO=SNATCH
DAÑO SECRETO=SECRET_POWER
BUCEO=DIVE
EMPUJÓN=ARM_THRUST
CAMUFLAJE=CAMOUFLAGE
LUMINICOLA*=TAIL_GLOW
RESPLANDOR=LUSTER_PURGE
BOLA NEBLINA=MIST_BALL
DANZA PLUMA=FEATHERDANCE
DANZA CAOS=TEETER_DANCE
PATADA ÍGNEA=BLAZE_KICK
CHAPOTEO LODO*=MUD_SPORT
BOLA HIELO=ICE_BALL
BRAZO PINCHO=NEEDLE_ARM
RELAJO=SLACK_OFF
VOZARRÓN=HYPER_VOICE
COLMILLO VENENO*=POISON_FANG
GARRA BRUTAL=CRUSH_CLAW
ANILLO ÍGNEO=BLAST_BURN
HIDROCAÑÓN=HYDRO_CANNON
PUÑO METEORO=METEOR_MASH
IMPRESIONAR=ASTONISH
METEOROBOLA=WEATHER_BALL
AROMATERAPIA=AROMATHERAPY
LLANTO FALSO=FAKE_TEARS
AIRE AFILADO=AIR_CUTTER
SOFOCO=OVERHEAT
RASTREO=ODOR_SLEUTH
TUMBA ROCAS=ROCK_TOMB
VIENTO PLATA=SILVER_WIND
ECO METÁLICO=METAL_SOUND
SILBATO=GRASSWHISTLE
COSQUILLAS=TICKLE
MASA CÓSMICA=COSMIC_POWER
SALPICAR=WATER_SPOUT
RAYO SEÑAL*=SIGNAL_BEAM
PUÑO SOMBRA=SHADOW_PUNCH
PARANORMAL=EXTRASENSORY
GANCHO ALTO=SKY_UPPERCUT
BUCLE ARENA=SAND_TOMB
FRÍO POLAR=SHEER_COLD
AGUA LODOSA=MUDDY_WATER
SEMILLADORA*=BULLET_SEED
GOLPE AÉREO=AERIAL_ACE
CARÁMBANO=ICICLE_SPEAR
DEFENSA FÉRREA*=IRON_DEFENSE
BLOQUEO=BLOCK
AULLIDO=HOWL
GARRA DRAGÓN=DRAGON_CLAW
PLANTA FEROZ=FRENZY_PLANT
CORPULENCIA=BULK_UP
BOTE=BOUNCE
DISPARO LODO*=MUD_SHOT
COLA VENENO=POISON_TAIL
ANTOJO=COVET
PLACAJE ELÉC=VOLT_TACKLE
HOJA MÁGICA=MAGICAL_LEAF
HIDROCHORRO=WATER_SPORT
PAZ MENTAL=CALM_MIND
HOJA AGUDA=LEAF_BLADE
DANZA DRAGÓN=DRAGON_DANCE
PEDRADA=ROCK_BLAST
ONDA VOLTIO=SHOCK_WAVE
HIDROPULSO=WATER_PULSE
DESEO OCULTO=DOOM_DESIRE
PSICOATAQUE=PSYCHO_BOOST