------------=MOVE_NONE
PFUND=POUND
KARATESCHLAG=KARATE_CHOP
DUPLEXHIEB=DOUBLESLAP
KOMETENHIEB=COMET_PUNCH
MEGAHIEB=MEGA_PUNCH
ZAHLTAG=PAY_DAY
FEUERSCHLAG=FIRE_PUNCH
EISHIEB=ICE_PUNCH
DONNERSCHLAG=THUNDERPUNCH
KRATZER=SCRATCH
KLAMMER=VICEGRIP
GUILLOTINE=GUILLOTINE
KLINGENSTURM=RAZOR_WIND
SCHWERTTANZ=SWORDS_DANCE
ZERSCHNEIDER=CUT
WINDSTOSS=GUST
FLÜGELSCHLAG=WING_ATTACK
WIRBELWIND=WHIRLWIND
FLIEGEN=FLY
KLAMMERGRIFF=BIND
SLAM=SLAM
RANKENHIEB=VINE_WHIP
STAMPFER=STOMP
DOPPELKICK=DOUBLE_KICK
MEGAKICK=MEGA_KICK
SPRUNGKICK=JUMP_KICK
FEGEKICK=ROLLING_KICK
SANDWIRBEL=SAND_ATTACK
KOPFNUSS=HEADBUTT
HORNATTACKE=HORN_ATTACK
FURIENSCHLAG=FURY_ATTACK
HORNBOHRER=HORN_DRILL
TACKLE=TACKLE
BODYSLAM=BODY_SLAM
WICKEL=WRAP
BODYCHECK=TAKE_DOWN
FUCHTLER=THRASH
RISIKOTACKLE=DOUBLE_EDGE
RUTENSCHLAG=TAIL_WHIP
GIFTSTACHEL=POISON_STING
DUONADEL=TWINEEDLE
NADELRAKETE=PIN_MISSILE
SILBERBLICK=LEER
BISS=BITE
HEULER=GROWL
BRÜLLER=ROAR
GESANG=SING
SUPERSCHALL=SUPERSONIC
ULTRASCHALL=SONICBOOM
AUSSETZER=DISABLE
SÄURE=ACID
GLUT=EMBER
FLAMMENWURF=FLAMETHROWER
WEISSNEBEL=MIST
AQUAKNARRE=WATER_GUN
HYDROPUMPE=HYDRO_PUMP
SURFER=SURF
EISSTRAHL=ICE_BEAM
BLIZZARD=BLIZZARD
PSYSTRAHL=PSYBEAM
BLUBBSTRAHL=BUBBLEBEAM
AURORASTRAHL=AURORA_BEAM
HYPERSTRAHL=HYPER_BEAM
PIKSER*=PECK
BOHRSCHNABEL=DRILL_PECK
ÜBERROLLER=SUBMISSION
FUSSKICK=LOW_KICK
KONTER=COUNTER
GEOWURF=SEISMIC_TOSS
STÄRKE=STRENGTH
ABSORBER=ABSORB
MEGASAUGER=MEGA_DRAIN
EGELSAMEN=LEECH_SEED
WACHSTUM=GROWTH
RASIERBLATT=RAZOR_LEAF
SOLARSTRAHL=SOLARBEAM
GIFTPUDER=POISONPOWDER
STACHELSPORE=STUN_SPORE
SCHLAFPUDER=SLEEP_POWDER
BLÄTTERTANZ=PETAL_DANCE
FADENSCHUSS=STRING_SHOT
DRACHENWUT=DRAGON_RAGE
FEUERWIRBEL=FIRE_SPIN
DONNERSCHOCK=THUNDERSHOCK
DONNERBLITZ=THUNDERBOLT
DONNERWELLE=THUNDER_WAVE
DONNER=THUNDER
STEINWURF=ROCK_THROW
ERDBEBEN=EARTHQUAKE
GEOFISSUR=FISSURE
SCHAUFLER=DIG
TOXIN=TOXIC
KONFUSION=CONFUSION
PSYCHOKINESE=PSYCHIC
HYPNOSE=HYPNOSIS
MEDITATION=MEDITATE
AGILITÄT=AGILITY
RUCKZUCKHIEB=QUICK_ATTACK
RASEREI=RAGE
TELEPORT=TELEPORT
NACHTNEBEL=NIGHT_SHADE
MIMIKRY=MIMIC
KREIDESCHREI=SCREECH
DOPPELTEAM=DOUBLE_TEAM
GENESUNG=RECOVER
HÄRTNER=HARDEN
KOMPRIMATOR=MINIMIZE
RAUCHWOLKE=SMOKESCREEN
KONFUSSTRAHL*=CONFUSE_RAY
PANZERSCHUTZ=WITHDRAW
EINIGLER=DEFENSE_CURL
BARRIERE=BARRIER
LICHTSCHILD=LIGHT_SCREEN
DUNKELNEBEL=HAZE
REFLEKTOR=REFLECT
ENERGIEFOKUS=FOCUS_ENERGY
GEDULD=BIDE
METRONOM=METRONOME
SPIEGELTRICK=MIRROR_MOVE
FINALE=SELFDESTRUCT
EIERBOMBE=EGG_BOMB
SCHLECKER=LICK
SMOG=SMOG
SCHLAMMBAD=SLUDGE
KNOCHENKEULE=BONE_CLUB
FEUERSTURM=FIRE_BLAST
KASKADE=WATERFALL
SCHNAPPER=CLAMP
STERNSCHAUER=SWIFT
SCHÄDELWUMME=SKULL_BASH
DORNKANONE=SPIKE_CANNON
UMKLAMMERUNG=CONSTRICT
AMNESIE=AMNESIA
PSYKRAFT=KINESIS
WEICHEI=SOFTBOILED
TURMKICK=HI_JUMP_KICK
SCHLANGENBLICK*=GLARE
TRAUMFRESSER=DREAM_EATER
GIFTWOLKE=POISON_GAS
STAKKATO=BARRAGE
BLUTSAUGER=LEECH_LIFE
TODESKUSS=LOVELY_KISS
HIMMELSFEGER=SKY_ATTACK
WANDLER*=TRANSFORM
BLUBBER=BUBBLE
IRRSCHLAG=DIZZY_PUNCH
PILZSPORE=SPORE
BLITZ=FLASH
PSYWELLE=PSYWAVE
PLATSCHER=SPLASH
SÄUREPANZER=ACID_ARMOR
KRABBHAMMER=CRABHAMMER
EXPLOSION=EXPLOSION
KRATZFURIE=FURY_SWIPES
KNOCHMERANG=BONEMERANG
ERHOLUNG=REST
STEINHAGEL=ROCK_SLIDE
HYPERZAHN=HYPER_FANG
SCHÄRFER=SHARPEN
UMWANDLUNG=CONVERSION
TRIPLETTE=TRI_ATTACK
SUPERZAHN=SUPER_FANG
SCHLITZER=SLASH
DELEGATOR=SUBSTITUTE
VERZWEIFLER=STRUGGLE
NACHAHMER=SKETCH
DREIFACHKICK=TRIPLE_KICK
RAUB=THIEF
SPINNENNETZ=SPIDER_WEB
WILLENSLESER=MIND_READER
NACHTMAHR=NIGHTMARE
FLAMMENRAD=FLAME_WHEEL
SCHNARCHER=SNORE
FLUCH=CURSE
DRESCHFLEGEL=FLAIL
UMWANDLUNG2=CONVERSION_2
LUFTSTOSS=AEROBLAST
BAUMWOLLSAAT=COTTON_SPORE
GEGENSCHLAG=REVERSAL
GROLL=SPITE
PULVERSCHNEE=POWDER_SNOW
SCHUTZSCHILD=PROTECT
TEMPOHIEB=MACH_PUNCH
GRIMASSE=SCARY_FACE
FINTE=FAINT_ATTACK
BITTERKUSS=SWEET_KISS
BAUCHTROMMEL=BELLY_DRUM
MATSCHBOMBE=SLUDGE_BOMB
LEHMSCHELLE=MUD_SLAP
OCTAZOOKA=OCTAZOOKA
STACHLER=SPIKES
BLITZKANONE=ZAP_CANNON
SCHARFBLICK*=FORESIGHT
ABGANGSBUND=DESTINY_BOND
ABGESANG=PERISH_SONG
EISSTURM=ICY_WIND
SCANNER=DETECT
KNOCHENHATZ=BONE_RUSH
ZIELSCHUSS=LOCK_ON
WUTANFALL=OUTRAGE
SANDSTURM=SANDSTORM
GIGASAUGER=GIGA_DRAIN
AUSDAUER=ENDURE
CHARME=CHARM
WALZER=ROLLOUT
TRUGSCHLAG=FALSE_SWIPE
ANGEBEREI=SWAGGER
MILCHGETRÄNK=MILK_DRINK
FUNKENSPRUNG=SPARK
ZORNKLINGE=FURY_CUTTER
STAHLFLÜGEL=STEEL_WING
HORRORBLICK=MEAN_LOOK
ANZIEHUNG=ATTRACT
SCHLAFREDE=SLEEP_TALK
VITALGLOCKE=HEAL_BELL
RÜCKKEHR=RETURN
GESCHENK=PRESENT
FRUSTRATION=FRUSTRATION
BODYGUARD=SAFEGUARD
LEIDTEILER=PAIN_SPLIT
LÄUTERFEUER=SACRED_FIRE
INTENSITÄT=MAGNITUDE
WUCHTSCHLAG=DYNAMICPUNCH
VIELENDER=MEGAHORN
FEUERODEM=DRAGONBREATH
STAFETTE*=BATON_PASS
ZUGABE=ENCORE
VERFOLGUNG=PURSUIT
TURBODREHER=RAPID_SPIN
LOCKDUFT=SWEET_SCENT
EISENSCHWEIF=IRON_TAIL
METALLKLAUE=METAL_CLAW
ÜBERWURF=VITAL_THROW
MORGENGRAUEN=MORNING_SUN
SYNTHESE=SYNTHESIS
MONDSCHEIN=MOONLIGHT
KRAFTRESERVE=HIDDEN_POWER
KREUZHIEB=CROSS_CHOP
WINDHOSE=TWISTER
REGENTANZ=RAIN_DANCE
SONNENTAG=SUNNY_DAY
KNIRSCHER=CRUNCH
SPIEGELCAPE=MIRROR_COAT
PSYCHO-PLUS=PSYCH_UP
TURBOTEMPO=EXTREMESPEED
ANTIK-KRAFT=ANCIENTPOWER
SPUKBALL=SHADOW_BALL
SEHER=FUTURE_SIGHT
ZERTRÜMMERER=ROCK_SMASH
WHIRLPOOL=WHIRLPOOL
PRÜGLER=BEAT_UP
MOGELHIEB=FAKE_OUT
AUFRUHR=UPROAR
HORTER=STOCKPILE
ENTFESSLER=SPIT_UP
VERZEHRER=SWALLOW
HITZEWELLE=HEAT_WAVE
HAGELSTURM=HAIL
FOLTERKNECHT=TORMENT
SCHMEICHLER=FLATTER
IRRLICHT=WILL_O_WISP
MEMENTO-MORI=MEMENTO
FASSADE=FACADE
POWER-PUNCH=FOCUS_PUNCH
RIECHSALZ=SMELLINGSALT
SPOTLIGHT=FOLLOW_ME
NATUR-KRAFT=NATURE_POWER
LADEVORGANG=CHARGE
VERHÖHNER=TAUNT
RECHTE HAND=HELPING_HAND
TRICKBETRUG=TRICK
ROLLENSPIEL*=ROLE_PLAY
WUNSCHTRAUM=WISH
ZUSCHUSS=ASSIST
VERWURZLER=INGRAIN
KRAFTKOLOSS=SUPERPOWER
MAGIEMANTEL=MAGIC_COAT
AUFBEREITUNG=RECYCLE
VERGELTUNG=REVENGE
DURCHBRUCH=BRICK_BREAK
GÄHNER=YAWN
ABSCHLAG=KNOCK_OFF
NOTSITUATION=ENDEAVOR
ERUPTION=ERUPTION
FÄHIGKEITSTAUSCH*=SKILL_SWAP
BEGRENZER=IMPRISON
HEILUNG=REFRESH
NACHSPIEL=GRUDGE
ÜBERNAHME=SNATCH
GEHEIMPOWER=SECRET_POWER
TAUCHER=DIVE
ARMSTOSS=ARM_THRUST
TARNUNG=CAMOUFLAGE
SCHWEIFGLANZ=TAIL_GLOW
SCHEINWERFER=LUSTER_PURGE
NEBELBALL=MIST_BALL
DAUNENREIGEN=FEATHERDANCE
TAUMELTANZ=TEETER_DANCE
FEUERFEGER=BLAZE_KICK
LEHMSUHLER=MUD_SPORT
FROSTBEULE=ICE_BALL
NIETENRANKE=NEEDLE_ARM
TAGEDIEB=SLACK_OFF
SCHALLWELLE=HYPER_VOICE
GIFTZAHN=POISON_FANG
ZERMALMKLAUE=CRUSH_CLAW
LOHEKANONADE=BLAST_BURN
AQUAHAUBITZE=HYDRO_CANNON
STERNENHIEB=METEOR_MASH
ERSTAUNER=ASTONISH
METEOROLOGE=WEATHER_BALL
AROMAKUR=AROMATHERAPY
TRUGTRÄNE=FAKE_TEARS
WINDSCHNITT=AIR_CUTTER
HITZEKOLLER=OVERHEAT
SCHNÜFFLER=ODOR_SLEUTH
FELSGRAB=ROCK_TOMB
SILBERHAUCH=SILVER_WIND
METALLSOUND=METAL_SOUND
GRASFLÖTE=GRASSWHISTLE
SPASSKANONE=TICKLE
KOSMIK-KRAFT=COSMIC_POWER
FONTRÄNEN=WATER_SPOUT
AMPELLEUCHTE=SIGNAL_BEAM
FINSTERFAUST=SHADOW_PUNCH
SONDERSENSOR=EXTRASENSORY
HIMMELHIEB=SKY_UPPERCUT
SANDGRAB=SAND_TOMB
EISESKÄLTE=SHEER_COLD
LEHMBRÜHE=MUDDY_WATER
KUGELSAAT=BULLET_SEED
AERO-ASS=AERIAL_ACE
EISSPEER=ICICLE_SPEAR
EISENABWEHR=IRON_DEFENSE
RÜCKENTZUG=BLOCK
JAULER=HOWL
DRACHENKLAUE=DRAGON_CLAW
FLORA-STATUE*=FRENZY_PLANT
PROTZER=BULK_UP
SPRUNGFEDER=BOUNCE
LEHMSCHUSS=MUD_SHOT
GIFTSCHWEIF=POISON_TAIL
BEZIRZER=COVET
VOLTTACKLE=VOLT_TACKLE
ZAUBERBLATT=MAGICAL_LEAF
NASSMACHER=WATER_SPORT
GEDANKENGUT=CALM_MIND
LAUBKLINGE=LEAF_BLADE
DRACHENTANZ=DRAGON_DANCE
FELSWURF=ROCK_BLAST
SCHOCKWELLE=SHOCK_WAVE
AQUAWELLE=WATER_PULSE
KISMETWUNSCH=DOOM_DESIRE
PSYSCHUB=PSYCHO_BOOST