------------=MOVE_NONE
ECRAS'FACE=POUND
POING-KARATÉ=KARATE_CHOP
TORGNOLES=DOUBLESLAP
POING COMÈTE=COMET_PUNCH
ULTIMAPOING=MEGA_PUNCH
JACKPOT=PAY_DAY
POING DE FEU=FIRE_PUNCH
POINGLACE=ICE_PUNCH
POING-ÉCLAIR=THUNDERPUNCH
GRIFFE=SCRATCH
FORCE POIGNE=VICEGRIP
GUILLOTINE=GUILLOTINE
COUPE-VENT=RAZOR_WIND
DANSE-LAMES=SWORDS_DANCE
COUPE=CUT
TORNADE=GUST
CRU-AILE=WING_ATTACK
CYCLONE=WHIRLWIND
VOL=FLY
ETREINTE=BIND
SOUPLESSE=SLAM
FOUET LIANES=VINE_WHIP
ECRASEMENT=STOMP
DOUBLE PIED=DOUBLE_KICK
ULTIMAWASHI=MEGA_KICK
PIED SAUTÉ=JUMP_KICK
MAWASHI GERI=ROLLING_KICK
JET DE SABLE=SAND_ATTACK
COUP D'BOULE=HEADBUTT
KOUD'KORNE=HORN_ATTACK
FURIE=FURY_ATTACK
EMPAL'KORNE=HORN_DRILL
CHARGE=TACKLE
PLAQUAGE=BODY_SLAM
LIGOTAGE=WRAP
BÉLIER=TAKE_DOWN
MANIA=THRASH
DAMOCLÈS=DOUBLE_EDGE
MIMI-QUEUE=TAIL_WHIP
DARD-VENIN=POISON_STING
DOUBLE-DARD=TWINEEDLE
DARD-NUÉE=PIN_MISSILE
GROZ'YEUX=LEER
MORSURE=BITE
RUGISSEMENT=GROWL
HURLEMENT=ROAR
BERCEUSE=SING
ULTRASON=SUPERSONIC
SONICBOOM=SONICBOOM
ENTRAVE=DISABLE
ACIDE=ACID
FLAMMÈCHE=EMBER
LANCE-FLAMME=FLAMETHROWER
BRUME=MIST
PISTOLET À O=WATER_GUN
HYDROCANON=HYDRO_PUMP
SURF=SURF
LASER GLACE=ICE_BEAM
BLIZZARD=BLIZZARD
RAFALE PSY=PSYBEAM
BULLES D'O=BUBBLEBEAM
ONDE BORÉALE=AURORA_BEAM
ULTRALASER=HYPER_BEAM
PICPIC=PECK
BEC VRILLE=DRILL_PECK
SACRIFICE=SUBMISSION
BALAYAGE=LOW_KICK
RIPOSTE=COUNTER
FRAPPE ATLAS=SEISMIC_TOSS
FORCE=STRENGTH
VOL-VIE=ABSORB
MÉGA-SANGSUE=MEGA_DRAIN
VAMPIGRAINE=LEECH_SEED
CROISSANCE=GROWTH
TRANCH'HERBE=RAZOR_LEAF
LANCE-SOLEIL=SOLARBEAM
POUDRE TOXIK=POISONPOWDER
PARA-SPORE=STUN_SPORE
POUDRE DODO=SLEEP_POWDER
DANSE-FLEUR=PETAL_DANCE
SÉCRÉTION=STRING_SHOT
DRACO-RAGE=DRAGON_RAGE
DANSEFLAMME=FIRE_SPIN
ECLAIR=THUNDERSHOCK
TONNERRE=THUNDERBOLT
CAGE-ECLAIR=THUNDER_WAVE
FATAL-FOUDRE=THUNDER
JET-PIERRES=ROCK_THROW
SÉISME=EARTHQUAKE
ABÎME=FISSURE
TUNNEL=DIG
TOXIK=TOXIC
CHOC MENTAL=CONFUSION
PSYKO=PSYCHIC
HYPNOSE=HYPNOSIS
YOGA=MEDITATE
HÂTE=AGILITY
VIVE-ATTAQUE=QUICK_ATTACK
FRÉNÉSIE=RAGE
TÉLÉPORT=TELEPORT
TÉNÈBRES=NIGHT_SHADE
COPIE=MIMIC
GRINCEMENT=SCREECH
REFLET=DOUBLE_TEAM
SOIN=RECOVER
ARMURE=HARDEN
LILLIPUT=MINIMIZE
BROUILLARD=SMOKESCREEN
ONDE FOLIE=CONFUSE_RAY
REPLI=WITHDRAW
BOUL'ARMURE=DEFENSE_CURL
BOUCLIER=BARRIER
MUR LUMIÈRE=LIGHT_SCREEN
BUÉE NOIRE=HAZE
PROTECTION=REFLECT
PUISSANCE=FOCUS_ENERGY
PATIENCE=BIDE
MÉTRONOME=METRONOME
MIMIQUE=MIRROR_MOVE
DESTRUCTION=SELFDESTRUCT
BOMB'OEUF=EGG_BOMB
LÉCHOUILLE=LICK
PURÉDPOIS=SMOG
DÉTRITUS=SLUDGE
MASSD'OS=BONE_CLUB
DÉFLAGRATION=FIRE_BLAST
CASCADE=WATERFALL
CLAQUOIR=CLAMP
MÉTÉORES=SWIFT
COUD'KRÂNE=SKULL_BASH
PICANON=SPIKE_CANNON
CONSTRICTION=CONSTRICT
AMNÉSIE=AMNESIA
TÉLÉKINÉSIE=KINESIS
E-COQUE=SOFTBOILED
PIED VOLTIGE=HI_JUMP_KICK
INTIMIDATION=GLARE
DÉVORÊVE=DREAM_EATER
GAZ TOXIK=POISON_GAS
PILONNAGE=BARRAGE
VAMPIRISME=LEECH_LIFE
GROBISOU=LOVELY_KISS
PIQUÉ=SKY_ATTACK
MORPHING=TRANSFORM
ECUME=BUBBLE
UPPERCUT=DIZZY_PUNCH
SPORE=SPORE
FLASH=FLASH
VAGUE PSY=PSYWAVE
TREMPETTE=SPLASH
ACIDARMURE=ACID_ARMOR
PINCE-MASSE=CRABHAMMER
EXPLOSION=EXPLOSION
COMBO-GRIFFE=FURY_SWIPES
OSMERANG=BONEMERANG
REPOS=REST
EBOULEMENT=ROCK_SLIDE
CROC DE MORT=HYPER_FANG
AFFÛTAGE=SHARPEN
ADAPTATION=CONVERSION
TRIPLATTAQUE=TRI_ATTACK
CROC FATAL=SUPER_FANG
TRANCHE=SLASH
CLONAGE=SUBSTITUTE
LUTTE=STRUGGLE
GRIBOUILLE=SKETCH
TRIPLE PIED=TRIPLE_KICK
LARCIN=THIEF
TOILE=SPIDER_WEB
LIRE-ESPRIT=MIND_READER
CAUCHEMAR=NIGHTMARE
ROUE DE FEU=FLAME_WHEEL
RONFLEMENT=SNORE
MALÉDICTION=CURSE
FLÉAU=FLAIL
ADAPTATION2=CONVERSION_2
AÉROBLAST=AEROBLAST
SPORE COTON=COTTON_SPORE
CONTRE=REVERSAL
DÉPIT=SPITE
POUDREUSE=POWDER_SNOW
ABRI=PROTECT
MACH PUNCH=MACH_PUNCH
GRIMACE=SCARY_FACE
FEINTE=FAINT_ATTACK
DOUX BAISER=SWEET_KISS
COGNOBIDON=BELLY_DRUM
BOMB-BEURK=SLUDGE_BOMB
COUD'BOUE=MUD_SLAP
OCTAZOOKA=OCTAZOOKA
PICOTS=SPIKES
ÉLECANON=ZAP_CANNON
CLAIRVOYANCE=FORESIGHT
PRLVT DESTIN=DESTINY_BOND
REQUIEM=PERISH_SONG
VENT GLACE=ICY_WIND
DÉTECTION=DETECT
CHARGE-OS=BONE_RUSH
VERROUILLAGE=LOCK_ON
COLÈRE=OUTRAGE
TEMPÊTE DE SABLE=SANDSTORM
GIGA-SANGSUE=GIGA_DRAIN
TÉNACITÉ=ENDURE
CHARME=CHARM
ROULADE=ROLLOUT
FAUX-CHAGE=FALSE_SWIPE
VANTARDISE=SWAGGER
LAIT À BOIRE=MILK_DRINK
ETINCELLE=SPARK
TAILLADE=FURY_CUTTER
AILE D'ACIER=STEEL_WING
REGARD NOIR=MEAN_LOOK
ATTRACTION=ATTRACT
BLABLA DODO=SLEEP_TALK
GLAS DE SOIN=HEAL_BELL
RETOUR=RETURN
CADEAU=PRESENT
FRUSTRATION=FRUSTRATION
RUNE PROTECT=SAFEGUARD
BALANCE=PAIN_SPLIT
FEU SACRÉ=SACRED_FIRE
AMPLEUR=MAGNITUDE
DYNAMOPOING=DYNAMICPUNCH
MÉGACORNE=MEGAHORN
DRACOSOUFFLE=DRAGONBREATH
RELAIS=BATON_PASS
ENCORE=ENCORE
POURSUITE=PURSUIT
TOUR RAPIDE=RAPID_SPIN
DOUX PARFUM=SWEET_SCENT
QUEUE DE FER=IRON_TAIL
GRIFFE ACIER=METAL_CLAW
CORPS PERDU=VITAL_THROW
AURORE=MORNING_SUN
SYNTHÈSE=SYNTHESIS
RAYON LUNE=MOONLIGHT
PUIS. CACHÉE=HIDDEN_POWER
COUP-CROIX=CROSS_CHOP
OURAGAN=TWISTER
DANSE PLUIE=RAIN_DANCE
ZÉNITH=SUNNY_DAY
MÂCHOUILLE=CRUNCH
VOILE MIROIR=MIRROR_COAT
BOOST=PSYCH_UP
VIT.EXTRÊME=EXTREMESPEED
POUV.ANTIQUE=ANCIENTPOWER
BALL'OMBRE=SHADOW_BALL
PRESCIENCE=FUTURE_SIGHT
ECLATE-ROC=ROCK_SMASH
SIPHON=WHIRLPOOL
BASTON=BEAT_UP
BLUFF=FAKE_OUT
BROUHAHA=UPROAR
STOCKAGE=STOCKPILE
RELÂCHE=SPIT_UP
AVALE=SWALLOW
CANICULE=HEAT_WAVE
GRÊLE=HAIL
TOURMENTE=TORMENT
FLATTERIE=FLATTER
FEU FOLLET=WILL_O_WISP
SOUVENIR=MEMENTO
FACADE=FACADE
MITRA-POING=FOCUS_PUNCH
STIMULANT=SMELLINGSALT
PAR ICI=FOLLOW_ME
FORCE-NATURE=NATURE_POWER
CHARGEUR=CHARGE
PROVOC=TAUNT
COUP D'MAIN=HELPING_HAND
TOURMAGIK=TRICK
IMITATION=ROLE_PLAY
VŒU=WISH
ASSISTANCE=ASSIST
RACINES=INGRAIN
SURPUISSANCE=SUPERPOWER
REFLET MAGIK=MAGIC_COAT
RECYCLAGE=RECYCLE
VENDETTA=REVENGE
CASSE-BRIQUE=BRICK_BREAK
BÂILLEMENT=YAWN
SABOTAGE=KNOCK_OFF
EFFORT=ENDEAVOR
ÉRUPTION=ERUPTION
ÉCHANGE=SKILL_SWAP
POSSESSIF=IMPRISON
RÉGÉNÉRATION=REFRESH
RANCUNE=GRUDGE
SAISIE=SNATCH
FORCE CACHÉE=SECRET_POWER
PLONGÉE=DIVE
COGNE=ARM_THRUST
CAMOUFLAGE=CAMOUFLAGE
LUMIQUEUE=TAIL_GLOW
LUMI-ÉCLAT=LUSTER_PURGE
BALL'BRUME=MIST_BALL
DANSE-PLUME=FEATHERDANCE
DANSE-FOLLE=TEETER_DANCE
PIED BRÛLEUR=BLAZE_KICK
LANCE-BOUE=MUD_SPORT
BALL'GLACE=ICE_BALL
POING DARD=NEEDLE_ARM
PARESSE=SLACK_OFF
MÉGAPHONE=HYPER_VOICE
CROCHETVENIN=POISON_FANG
ECLATEGRIFFE=CRUSH_CLAW
RAFALE FEU=BLAST_BURN
HYDROBLAST=HYDRO_CANNON
POING MÉTÉOR=METEOR_MASH
ÉTONNEMENT=ASTONISH
BALL'MÉTÉO=WEATHER_BALL
AROMATHÉRAPIE=AROMATHERAPY
CROCO LARME=FAKE_TEARS
TRANCH'AIR=AIR_CUTTER
SURCHAUFFE=OVERHEAT
FLAIR=ODOR_SLEUTH
TOMBEROCHE=ROCK_TOMB
VENT ARGENTÉ=SILVER_WIND
STRIDO-SON=METAL_SOUND
SIFFL'HERBE=GRASSWHISTLE
CHATOUILLE=TICKLE
FORCE COSMIK=COSMIC_POWER
GICLÉDO=WATER_SPOUT
RAYON SIGNAL=SIGNAL_BEAM
POING OMBRE=SHADOW_PUNCH
EXTRASENSEUR=EXTRASENSORY
STRATOPERCUT=SKY_UPPERCUT
TOURBI-SABLE=SAND_TOMB
GLACIATION=SHEER_COLD
OCROUPI=MUDDY_WATER
BALLE GRAINE=BULLET_SEED
AÉROPIQUE=AERIAL_ACE
STALAGTITE=ICICLE_SPEAR
MUR DE FER=IRON_DEFENSE
BARRAGE=BLOCK
GRONDEMENT=HOWL
DRACOGRIFFE=DRAGON_CLAW
VÉGÉ-ATTAK=FRENZY_PLANT
GONFLETTE=BULK_UP
REBOND=BOUNCE
TIR DE BOUE=MUD_SHOT
QUEUE-POISON=POISON_TAIL
IMPLORE=COVET
ELECTACLE=VOLT_TACKLE
FEUILLEMAGIK=MAGICAL_LEAF
TOURNIQUET=WATER_SPORT
PLÉNITUDE=CALM_MIND
LAME-FEUILLE=LEAF_BLADE
DANSE DRACO=DRAGON_DANCE
BOULE ROC=ROCK_BLAST
ONDE DE CHOC=SHOCK_WAVE
VIBRAQUA=WATER_PULSE
CARNAREKET=DOOM_DESIRE
PSYCHO BOOST=PSYCHO_BOOST