------------=MOVE_NONE
はたく=POUND
からてチョップ=KARATE_CHOP
おうふくビンタ=DOUBLESLAP
れんぞくパンチ=COMET_PUNCH
メガトンパンチ=MEGA_PUNCH
ネコにこばん=PAY_DAY
ほのおのパンチ=FIRE_PUNCH
れいとうパンチ=ICE_PUNCH
かみなりパンチ=THUNDERPUNCH
ひっかく=SCRATCH
はさむ=VICEGRIP
ハサミギロチン=GUILLOTINE
かまいたち=RAZOR_WIND
つるぎのまい=SWORDS_DANCE
いあいぎり=CUT
かぜおこし=GUST
つばさでうつ=WING_ATTACK
ふきとばし=WHIRLWIND
そらをとぶ=FLY
しめつける=BIND
たたきつける=SLAM
つるのムチ=VINE_WHIP
ふみつけ=STOMP
にどげり=DOUBLE_KICK
メガトンキック=MEGA_KICK
とびげり=JUMP_KICK
まわしげり=ROLLING_KICK
すなかけ=SAND_ATTACK
ずつき=HEADBUTT
つのでつく=HORN_ATTACK
みだれづき=FURY_ATTACK
つのドリル=HORN_DRILL
たいあたり=TACKLE
のしかかり=BODY_SLAM
まきつく=WRAP
とっしん=TAKE_DOWN
あばれる=THRASH
すてみタックル=DOUBLE_EDGE
しっぽをふる=TAIL_WHIP
どくばり=POISON_STING
ダブルニードル=TWINEEDLE
ミサイルばり=PIN_MISSILE
にらみつける=LEER
かみつく=BITE
なきごえ=GROWL
ほえる=ROAR
うたう=SING
ちょうおんぱ=SUPERSONIC
ソニックブーム=SONICBOOM
かなしばり=DISABLE
ようかいえき=ACID
ひのこ=EMBER
かえんほうしゃ=FLAMETHROWER
しろいきり=MIST
みずでっぽう=WATER_GUN
ハイドロポンプ=HYDRO_PUMP
なみのり=SURF
れいとうビーム=ICE_BEAM
ふぶき=BLIZZARD
サイケこうせん=PSYBEAM
バブルこうせん=BUBBLEBEAM
オーロラビーム=AURORA_BEAM
はかいこうせん=HYPER_BEAM
つつく=PECK
ドリルくちばし=DRILL_PECK
じごくぐるま=SUBMISSION
けたぐり=LOW_KICK
カウンター=COUNTER
ちきゅうなげ=SEISMIC_TOSS
かいりき=STRENGTH
すいとる=ABSORB
メガドレイン=MEGA_DRAIN
やどりぎのタネ=LEECH_SEED
せいちょう=GROWTH
はっぱカッター=RAZOR_LEAF
ソーラービーム=SOLARBEAM
どくのこな=POISONPOWDER
しびれごな=STUN_SPORE
ねむりごな=SLEEP_POWDER
はなびらのまい=PETAL_DANCE
いとをはく=STRING_SHOT
りゅうのいかり=DRAGON_RAGE
ほのおのうず=FIRE_SPIN
でんきショック=THUNDERSHOCK
１０まんボルト=THUNDERBOLT
でんじは=THUNDER_WAVE
かみなり=THUNDER
いわおとし=ROCK_THROW
じしん=EARTHQUAKE
じわれ=FISSURE
あなをほる=DIG
どくどく=TOXIC
ねんりき=CONFUSION
サイコキネシス=PSYCHIC
さいみんじゅつ=HYPNOSIS
ヨガのポーズ=MEDITATE
こうそくいどう=AGILITY
でんこうせっか=QUICK_ATTACK
いかり=RAGE
テレポート=TELEPORT
ナイトヘッド=NIGHT_SHADE
ものまね=MIMIC
いやなおと=SCREECH
かげぶんしん=DOUBLE_TEAM
じこさいせい=RECOVER
かたくなる=HARDEN
ちいさくなる=MINIMIZE
えんまく=SMOKESCREEN
あやしいひかり=CONFUSE_RAY
からにこもる=WITHDRAW
まるくなる=DEFENSE_CURL
バリアー=BARRIER
ひかりのかべ=LIGHT_SCREEN
くろいきり=HAZE
リフレクター=REFLECT
きあいだめ=FOCUS_ENERGY
がまん=BIDE
ゆびをふる=METRONOME
オウムがえし=MIRROR_MOVE
じばく=SELFDESTRUCT
タマゴばくだん=EGG_BOMB
したでなめる=LICK
スモッグ=SMOG
ヘドロこうげき=SLUDGE
ホネこんぼう=BONE_CLUB
だいもんじ=FIRE_BLAST
たきのぼり=WATERFALL
からではさむ=CLAMP
スピードスター=SWIFT
ロケットずつき=SKULL_BASH
とげキャノン=SPIKE_CANNON
からみつく=CONSTRICT
ドわすれ=AMNESIA
スプーンまげ=KINESIS
タマゴうみ=SOFTBOILED
とびひざげり=HI_JUMP_KICK
へびにらみ=GLARE
ゆめくい=DREAM_EATER
どくガス=POISON_GAS
たまなげ=BARRAGE
きゅうけつ=LEECH_LIFE
あくまのキッス=LOVELY_KISS
ゴッドバード=SKY_ATTACK
へんしん=TRANSFORM
あわ=BUBBLE
ピヨピヨパンチ=DIZZY_PUNCH
キノコのほうし=SPORE
フラッシュ=FLASH
サイコウェーブ=PSYWAVE
はねる=SPLASH
とける=ACID_ARMOR
クラブハンマー=CRABHAMMER
だいばくはつ=EXPLOSION
みだれひっかき=FURY_SWIPES
ホネブーメラン=BONEMERANG
ねむる=REST
いわなだれ=ROCK_SLIDE
ひっさつまえば=HYPER_FANG
かくばる=SHARPEN
テクスチャー=CONVERSION
トライアタック=TRI_ATTACK
いかりのまえば=SUPER_FANG
きりさく=SLASH
みがわり=SUBSTITUTE
わるあがき=STRUGGLE
スケッチ=SKETCH
トリプルキック=TRIPLE_KICK
どろぼう=THIEF
クモのす=SPIDER_WEB
こころのめ=MIND_READER
あくむ=NIGHTMARE
かえんぐるま=FLAME_WHEEL
いびき=SNORE
のろい=CURSE
じたばた=FLAIL
テクスチャー２=CONVERSION_2
エアロブラスト=AEROBLAST
わたほうし=COTTON_SPORE
きしかいせい=REVERSAL
うらみ=SPITE
こなゆき=POWDER_SNOW
まもる=PROTECT
マッハパンチ=MACH_PUNCH
こわいかお=SCARY_FACE
だましうち=FAINT_ATTACK
てんしのキッス=SWEET_KISS
はらだいこ=BELLY_DRUM
ヘドロばくだん=SLUDGE_BOMB
どろかけ=MUD_SLAP
オクタンほう=OCTAZOOKA
まきびし=SPIKES
でんじほう=ZAP_CANNON
みやぶる=FORESIGHT
みちづれ=DESTINY_BOND
ほろびのうた=PERISH_SONG
こごえるかぜ=ICY_WIND
みきり=DETECT
ボーンラッシュ=BONE_RUSH
ロックオン=LOCK_ON
げきりん=OUTRAGE
すなあらし=SANDSTORM
ギガドレイン=GIGA_DRAIN
こらえる=ENDURE
あまえる=CHARM
ころがる=ROLLOUT
みねうち=FALSE_SWIPE
いばる=SWAGGER
ミルクのみ=MILK_DRINK
スパーク=SPARK
れんぞくぎり=FURY_CUTTER
はがねのつばさ=STEEL_WING
くろいまなざし=MEAN_LOOK
メロメロ=ATTRACT
ねごと=SLEEP_TALK
いやしのすず=HEAL_BELL
おんがえし=RETURN
プレゼント=PRESENT
やつあたり=FRUSTRATION
しんぴのまもり=SAFEGUARD
いたみわけ=PAIN_SPLIT
せいなるほのお=SACRED_FIRE
マグニチュード=MAGNITUDE
ばくれつパンチ=DYNAMICPUNCH
メガホーン=MEGAHORN
りゅうのいぶき=DRAGONBREATH
バトンタッチ=BATON_PASS
アンコール=ENCORE
おいうち=PURSUIT
こうそくスピン=RAPID_SPIN
あまいかおり=SWEET_SCENT
アイアンテール=IRON_TAIL
メタルクロー=METAL_CLAW
あてみなげ=VITAL_THROW
あさのひざし=MORNING_SUN
こうごうせい=SYNTHESIS
つきのひかり=MOONLIGHT
めざめるパワー=HIDDEN_POWER
クロスチョップ=CROSS_CHOP
たつまき=TWISTER
あまごい=RAIN_DANCE
にほんばれ=SUNNY_DAY
かみくだく=CRUNCH
ミラーコート=MIRROR_COAT
じこあんじ=PSYCH_UP
しんそく=EXTREMESPEED
げんしのちから=ANCIENTPOWER
シャドーボール=SHADOW_BALL
みらいよち=FUTURE_SIGHT
いわくだき=ROCK_SMASH
うずしお=WHIRLPOOL
ふくろだたき=BEAT_UP
ねこだまし=FAKE_OUT
さわぐ=UPROAR
たくわえる=STOCKPILE
はきだす=SPIT_UP
のみこむ=SWALLOW
ねっぷう=HEAT_WAVE
あられ=HAIL
いちゃもん=TORMENT
おだてる=FLATTER
おにび=WILL_O_WISP
おきみやげ=MEMENTO
からげんき=FACADE
きあいパンチ=FOCUS_PUNCH
きつけ=SMELLINGSALT
このゆびとまれ=FOLLOW_ME
しぜんのちから=NATURE_POWER
じゅうでん=CHARGE
ちょうはつ=TAUNT
てだすけ=HELPING_HAND
トリック=TRICK
なりきり=ROLE_PLAY
ねがいごと=WISH
ねこのて=ASSIST
ねをはる=INGRAIN
ばかぢから=SUPERPOWER
マジックコート=MAGIC_COAT
リサイクル=RECYCLE
リベンジ=REVENGE
かわらわり=BRICK_BREAK
あくび=YAWN
はたきおとす=KNOCK_OFF
がむしゃら=ENDEAVOR
ふんか=ERUPTION
スキルスワップ=SKILL_SWAP
ふういん=IMPRISON
リフレッシュ=REFRESH
おんねん=GRUDGE
よこどり=SNATCH
ひみつのちから=SECRET_POWER
ダイビング=DIVE
つっぱり=ARM_THRUST
ほごしょく=CAMOUFLAGE
ほたるび=TAIL_GLOW
ラスターパージ=LUSTER_PURGE
ミストボール=MIST_BALL
フェザーダンス=FEATHERDANCE
フラフラダンス=TEETER_DANCE
ブレイズキック=BLAZE_KICK
どろあそび=MUD_SPORT
アイスボール=ICE_BALL
ニードルアーム=NEEDLE_ARM
なまける=SLACK_OFF
ハイパーボイス=HYPER_VOICE
どくどくのキバ=POISON_FANG
ブレイククロー=CRUSH_CLAW
ブラストバーン=BLAST_BURN
ハイドロカノン=HYDRO_CANNON
コメットパンチ=METEOR_MASH
おどろかす=ASTONISH
ウェザーボール=WEATHER_BALL
アロマセラピー=AROMATHERAPY
うそなき=FAKE_TEARS
エアカッター=AIR_CUTTER
オーバーヒート=OVERHEAT
かぎわける=ODOR_SLEUTH
がんせきふうじ=ROCK_TOMB
ぎんいろのかぜ=SILVER_WIND
きんぞくおん=METAL_SOUND
くさぶえ=GRASSWHISTLE
くすぐる=TICKLE
コスモパワー=COSMIC_POWER
しおふき=WATER_SPOUT
シグナルビーム=SIGNAL_BEAM
シャドーパンチ=SHADOW_PUNCH
じんつうりき=EXTRASENSORY
スカイアッパー=SKY_UPPERCUT
すなじごく=SAND_TOMB
ぜったいれいど=SHEER_COLD
だくりゅう=MUDDY_WATER
タネマシンガン=BULLET_SEED
つばめがえし=AERIAL_ACE
つららばり=ICICLE_SPEAR
てっぺき=IRON_DEFENSE
とおせんぼう=BLOCK
とおぼえ=HOWL
ドラゴンクロー=DRAGON_CLAW
ハードプラント=FRENZY_PLANT
ビルドアップ=BULK_UP
とびはねる=BOUNCE
マッドショット=MUD_SHOT
ポイズンテール=POISON_TAIL
ほしがる=COVET
ボルテッカー=VOLT_TACKLE
マジカルリーフ=MAGICAL_LEAF
みずあそび=WATER_SPORT
めいそう=CALM_MIND
リーフブレード=LEAF_BLADE
りゅうのまい=DRAGON_DANCE
ロックブラスト=ROCK_BLAST
でんげきは=SHOCK_WAVE
みずのはどう=WATER_PULSE
はめつのねがい=DOOM_DESIRE
サイコブースト=PSYCHO_BOOST