------------=MOVE_NONE
POUND=POUND
KARATE CHOP=KARATE_CHOP
DOUBLESLAP=DOUBLESLAP
COMET PUNCH=COMET_PUNCH
MEGA PUNCH=MEGA_PUNCH
PAY DAY=PAY_DAY
FIRE PUNCH=FIRE_PUNCH
ICE PUNCH=ICE_PUNCH
THUNDERPUNCH=THUNDERPUNCH
SCRATCH=SCRATCH
VICEGRIP=VICEGRIP
GUILLOTINE=GUILLOTINE
RAZOR WIND=RAZOR_WIND
SWORDS DANCE=SWORDS_DANCE
CUT=CUT
GUST=GUST
WING ATTACK=WING_ATTACK
WHIRLWIND=WHIRLWIND
FLY=FLY
BIND=BIND
SLAM=SLAM
VINE WHIP=VINE_WHIP
STOMP=STOMP
DOUBLE KICK=DOUBLE_KICK
MEGA KICK=MEGA_KICK
JUMP KICK=JUMP_KICK
ROLLING KICK=ROLLING_KICK
SAND ATTACK=SAND_ATTACK
HEADBUTT=HEADBUTT
HORN ATTACK=HORN_ATTACK
FURY ATTACK=FURY_ATTACK
HORN DRILL=HORN_DRILL
TACKLE=TACKLE
BODY SLAM=BODY_SLAM
WRAP=WRAP
TAKE DOWN=TAKE_DOWN
THRASH=THRASH
DOUBLE EDGE=DOUBLE_EDGE
TAIL WHIP=TAIL_WHIP
POISON STING=POISON_STING
TWINEEDLE=TWINEEDLE
PIN MISSILE=PIN_MISSILE
LEER=LEER
BITE=BITE
GROWL=GROWL
ROAR=ROAR
SING=SING
SUPERSONIC=SUPERSONIC
SONICBOOM=SONICBOOM
DISABLE=DISABLE
ACID=ACID
EMBER=EMBER
FLAMETHROWER=FLAMETHROWER
MIST=MIST
WATER GUN=WATER_GUN
HYDRO PUMP=HYDRO_PUMP
SURF=SURF
ICE BEAM=ICE_BEAM
BLIZZARD=BLIZZARD
PSYBEAM=PSYBEAM
BUBBLEBEAM=BUBBLEBEAM
AURORA BEAM=AURORA_BEAM
HYPER BEAM=HYPER_BEAM
PECK=PECK
DRILL PECK=DRILL_PECK
SUBMISSION=SUBMISSION
LOW KICK=LOW_KICK
COUNTER=COUNTER
SEISMIC TOSS=SEISMIC_TOSS
STRENGTH=STRENGTH
ABSORB=ABSORB
MEGA DRAIN=MEGA_DRAIN
LEECH SEED=LEECH_SEED
GROWTH=GROWTH
RAZOR LEAF=RAZOR_LEAF
SOLARBEAM=SOLARBEAM
POISONPOWDER=POISONPOWDER
STUN SPORE=STUN_SPORE
SLEEP POWDER=SLEEP_POWDER
PETAL DANCE=PETAL_DANCE
STRING SHOT=STRING_SHOT
DRAGON RAGE=DRAGON_RAGE
FIRE SPIN=FIRE_SPIN
THUNDERSHOCK=THUNDERSHOCK
THUNDERBOLT=THUNDERBOLT
THUNDER WAVE=THUNDER_WAVE
THUNDER=THUNDER
ROCK THROW=ROCK_THROW
EARTHQUAKE=EARTHQUAKE
FISSURE=FISSURE
DIG=DIG
TOXIC=TOXIC
CONFUSION=CONFUSION
PSYCHIC=PSYCHIC
HYPNOSIS=HYPNOSIS
MEDITATE=MEDITATE
AGILITY=AGILITY
QUICK ATTACK=QUICK_ATTACK
RAGE=RAGE
TELEPORT=TELEPORT
NIGHT SHADE=NIGHT_SHADE
MIMIC=MIMIC
SCREECH=SCREECH
DOUBLE TEAM=DOUBLE_TEAM
RECOVER=RECOVER
HARDEN=HARDEN
MINIMIZE=MINIMIZE
SMOKESCREEN=SMOKESCREEN
CONFUSE RAY=CONFUSE_RAY
WITHDRAW=WITHDRAW
DEFENSE CURL=DEFENSE_CURL
BARRIER=BARRIER
LIGHT SCREEN=LIGHT_SCREEN
HAZE=HAZE
REFLECT=REFLECT
FOCUS ENERGY=FOCUS_ENERGY
BIDE=BIDE
METRONOME=METRONOME
MIRROR MOVE=MIRROR_MOVE
SELFDESTRUCT=SELFDESTRUCT
EGG BOMB=EGG_BOMB
LICK=LICK
SMOG=SMOG
SLUDGE=SLUDGE
BONE CLUB=BONE_CLUB
FIRE BLAST=FIRE_BLAST
WATERFALL=WATERFALL
CLAMP=CLAMP
SWIFT=SWIFT
SKULL BASH=SKULL_BASH
SPIKE CANNON=SPIKE_CANNON
CONSTRICT=CONSTRICT
AMNESIA=AMNESIA
KINESIS=KINESIS
SOFTBOILED=SOFTBOILED
HI_JUMP KICK=HI_JUMP_KICK
GLARE=GLARE
DREAM EATER=DREAM_EATER
POISON GAS=POISON_GAS
BARRAGE=BARRAGE
LEECH LIFE=LEECH_LIFE
LOVELY KISS=LOVELY_KISS
SKY ATTACK=SKY_ATTACK
TRANSFORM=TRANSFORM
BUBBLE=BUBBLE
DIZZY PUNCH=DIZZY_PUNCH
SPORE=SPORE
FLASH=FLASH
PSYWAVE=PSYWAVE
SPLASH=SPLASH
ACID ARMOR=ACID_ARMOR
CRABHAMMER=CRABHAMMER
EXPLOSION=EXPLOSION
FURY SWIPES=FURY_SWIPES
BONEMERANG=BONEMERANG
REST=REST
ROCK SLIDE=ROCK_SLIDE
HYPER FANG=HYPER_FANG
SHARPEN=SHARPEN
CONVERSION=CONVERSION
TRI ATTACK=TRI_ATTACK
SUPER FANG=SUPER_FANG
SLASH=SLASH
SUBSTITUTE=SUBSTITUTE
STRUGGLE=STRUGGLE
SKETCH=SKETCH
TRIPLE KICK=TRIPLE_KICK
THIEF=THIEF
SPIDER WEB=SPIDER_WEB
MIND READER=MIND_READER
NIGHTMARE=NIGHTMARE
FLAME WHEEL=FLAME_WHEEL
SNORE=SNORE
CURSE=CURSE
FLAIL=FLAIL
CONVERSION 2=CONVERSION_2
AEROBLAST=AEROBLAST
COTTON SPORE=COTTON_SPORE
REVERSAL=REVERSAL
SPITE=SPITE
POWDER SNOW=POWDER_SNOW
PROTECT=PROTECT
MACH PUNCH=MACH_PUNCH
SCARY FACE=SCARY_FACE
FAINT ATTACK=FAINT_ATTACK
SWEET KISS=SWEET_KISS
BELLY DRUM=BELLY_DRUM
SLUDGE BOMB=SLUDGE_BOMB
MUD SLAP=MUD_SLAP
OCTAZOOKA=OCTAZOOKA
SPIKES=SPIKES
ZAP CANNON=ZAP_CANNON
FORESIGHT=FORESIGHT
DESTINY BOND=DESTINY_BOND
PERISH SONG=PERISH_SONG
ICY WIND=ICY_WIND
DETECT=DETECT
BONE RUSH=BONE_RUSH
LOCK ON=LOCK_ON
OUTRAGE=OUTRAGE
SANDSTORM=SANDSTORM
GIGA DRAIN=GIGA_DRAIN
ENDURE=ENDURE
CHARM=CHARM
ROLLOUT=ROLLOUT
FALSE SWIPE=FALSE_SWIPE
SWAGGER=SWAGGER
MILK DRINK=MILK_DRINK
SPARK=SPARK
FURY CUTTER=FURY_CUTTER
STEEL WING=STEEL_WING
MEAN LOOK=MEAN_LOOK
ATTRACT=ATTRACT
SLEEP TALK=SLEEP_TALK
HEAL BELL=HEAL_BELL
RETURN=RETURN
PRESENT=PRESENT
FRUSTRATION=FRUSTRATION
SAFEGUARD=SAFEGUARD
PAIN SPLIT=PAIN_SPLIT
SACRED FIRE=SACRED_FIRE
MAGNITUDE=MAGNITUDE
DYNAMICPUNCH=DYNAMICPUNCH
MEGAHORN=MEGAHORN
DRAGONBREATH=DRAGONBREATH
BATON PASS=BATON_PASS
ENCORE=ENCORE
PURSUIT=PURSUIT
RAPID SPIN=RAPID_SPIN
SWEET SCENT=SWEET_SCENT
IRON TAIL=IRON_TAIL
METAL CLAW=METAL_CLAW
VITAL THROW=VITAL_THROW
MORNING SUN=MORNING_SUN
SYNTHESIS=SYNTHESIS
MOONLIGHT=MOONLIGHT
HIDDEN POWER=HIDDEN_POWER
CROSS CHOP=CROSS_CHOP
TWISTER=TWISTER
RAIN DANCE=RAIN_DANCE
SUNNY DAY=SUNNY_DAY
CRUNCH=CRUNCH
MIRROR COAT=MIRROR_COAT
PSYCH UP=PSYCH_UP
EXTREMESPEED=EXTREMESPEED
ANCIENTPOWER=ANCIENTPOWER
SHADOW BALL=SHADOW_BALL
FUTURE SIGHT=FUTURE_SIGHT
ROCK SMASH=ROCK_SMASH
WHIRLPOOL=WHIRLPOOL
BEAT UP=BEAT_UP
FAKE OUT=FAKE_OUT
UPROAR=UPROAR
STOCKPILE=STOCKPILE
SPIT UP=SPIT_UP
SWALLOW=SWALLOW
HEAT WAVE=HEAT_WAVE
HAIL=HAIL
TORMENT=TORMENT
FLATTER=FLATTER
WILL_O WISP=WILL_O_WISP
MEMENTO=MEMENTO
FACADE=FACADE
FOCUS PUNCH=FOCUS_PUNCH
SMELLINGSALT=SMELLINGSALT
FOLLOW ME=FOLLOW_ME
NATURE POWER=NATURE_POWER
CHARGE=CHARGE
TAUNT=TAUNT
HELPING HAND=HELPING_HAND
TRICK=TRICK
ROLE PLAY=ROLE_PLAY
WISH=WISH
ASSIST=ASSIST
INGRAIN=INGRAIN
SUPERPOWER=SUPERPOWER
MAGIC COAT=MAGIC_COAT
RECYCLE=RECYCLE
REVENGE=REVENGE
BRICK BREAK=BRICK_BREAK
YAWN=YAWN
KNOCK OFF=KNOCK_OFF
ENDEAVOR=ENDEAVOR
ERUPTION=ERUPTION
SKILL SWAP=SKILL_SWAP
IMPRISON=IMPRISON
REFRESH=REFRESH
GRUDGE=GRUDGE
SNATCH=SNATCH
SECRET POWER=SECRET_POWER
DIVE=DIVE
ARM THRUST=ARM_THRUST
CAMOUFLAGE=CAMOUFLAGE
TAIL GLOW=TAIL_GLOW
LUSTER PURGE=LUSTER_PURGE
MIST BALL=MIST_BALL
FEATHERDANCE=FEATHERDANCE
TEETER DANCE=TEETER_DANCE
BLAZE KICK=BLAZE_KICK
MUD SPORT=MUD_SPORT
ICE BALL=ICE_BALL
NEEDLE ARM=NEEDLE_ARM
SLACK OFF=SLACK_OFF
HYPER VOICE=HYPER_VOICE
POISON FANG=POISON_FANG
CRUSH CLAW=CRUSH_CLAW
BLAST BURN=BLAST_BURN
HYDRO CANNON=HYDRO_CANNON
METEOR MASH=METEOR_MASH
ASTONISH=ASTONISH
WEATHER BALL=WEATHER_BALL
AROMATHERAPY=AROMATHERAPY
FAKE TEARS=FAKE_TEARS
AIR CUTTER=AIR_CUTTER
OVERHEAT=OVERHEAT
ODOR SLEUTH=ODOR_SLEUTH
ROCK TOMB=ROCK_TOMB
SILVER WIND=SILVER_WIND
METAL SOUND=METAL_SOUND
GRASSWHISTLE=GRASSWHISTLE
TICKLE=TICKLE
COSMIC POWER=COSMIC_POWER
WATER SPOUT=WATER_SPOUT
SIGNAL BEAM=SIGNAL_BEAM
SHADOW PUNCH=SHADOW_PUNCH
EXTRASENSORY=EXTRASENSORY
SKY UPPERCUT=SKY_UPPERCUT
SAND TOMB=SAND_TOMB
SHEER COLD=SHEER_COLD
MUDDY WATER=MUDDY_WATER
BULLET SEED=BULLET_SEED
AERIAL ACE=AERIAL_ACE
ICICLE SPEAR=ICICLE_SPEAR
IRON DEFENSE=IRON_DEFENSE
BLOCK=BLOCK
HOWL=HOWL
DRAGON CLAW=DRAGON_CLAW
FRENZY PLANT=FRENZY_PLANT
BULK UP=BULK_UP
BOUNCE=BOUNCE
MUD SHOT=MUD_SHOT
POISON TAIL=POISON_TAIL
COVET=COVET
VOLT TACKLE=VOLT_TACKLE
MAGICAL LEAF=MAGICAL_LEAF
WATER SPORT=WATER_SPORT
CALM MIND=CALM_MIND
LEAF BLADE=LEAF_BLADE
DRAGON DANCE=DRAGON_DANCE
ROCK BLAST=ROCK_BLAST
SHOCK WAVE=SHOCK_WAVE
WATER PULSE=WATER_PULSE
DOOM DESIRE=DOOM_DESIRE
PSYCHO BOOST=PSYCHO_BOOST