------------=MOVE_NONE
BOTTA*=POUND
COLPOKARATE=KARATE_CHOP
DOPPIASBERLA=DOUBLESLAP
COMETAPUGNO=COMET_PUNCH
MEGAPUGNO=MEGA_PUNCH
GIORNOPAGA=PAY_DAY
FUOCOPUGNO=FIRE_PUNCH
GELOPUGNO=ICE_PUNCH
TUONOPUGNO=THUNDERPUNCH
GRAFFIO=SCRATCH
PRESA=VICEGRIP
GHIGLIOTTINA=GUILLOTINE
VENTAGLIENTE=RAZOR_WIND
DANZASPADA=SWORDS_DANCE
TAGLIO=CUT
RAFFICA=GUST
ATTACCO D'ALA=WING_ATTACK
TURBINE=WHIRLWIND
VOLO=FLY
LEGATUTTO=BIND
SCHIANTO=SLAM
FRUSTATA=VINE_WHIP
PESTONE=STOMP
DOPPIOCALCIO=DOUBLE_KICK
MEGACALCIO=MEGA_KICK
CALCIOSALTO=JUMP_KICK
CALCIORULLO=ROLLING_KICK
TURBOSABBIA=SAND_ATTACK
BOTTINTESTA=HEADBUTT
INCORNATA=HORN_ATTACK
FURIA=FURY_ATTACK
PERFORCORNO=HORN_DRILL
AZIONE=TACKLE
CORPOSCONTRO*=BODY_SLAM
AVVOLGIBOTTA=WRAP
RIDUTTORE=TAKE_DOWN
COLPO=THRASH
SDOPPIATORE=DOUBLE_EDGE
COLPOCODA=TAIL_WHIP
VELENOSPINA=POISON_STING
DOPPIO AGO=TWINEEDLE
MISSILSPILLO=PIN_MISSILE
FULMISGUARDO=LEER
MORSO=BITE
RUGGITO=GROWL
BOATO=ROAR
CANTO=SING
SUPERSUONO=SUPERSONIC
SONICBOOM=SONICBOOM
INIBITORE=DISABLE
ACIDO=ACID
BRACIERE=EMBER
LANCIAFIAMME=FLAMETHROWER
NEBBIA=MIST
PISTOLACQUA=WATER_GUN
IDROPOMPA=HYDRO_PUMP
SURF=SURF
GELORAGGIO=ICE_BEAM
BORA=BLIZZARD
PSICORAGGIO=PSYBEAM
BOLLARAGGIO=BUBBLEBEAM
RAGGIAURORA=AURORA_BEAM
IPER RAGGIO=HYPER_BEAM
BECCATA=PECK
PERFORBECCO=DRILL_PECK
SOTTOMISSIONE=SUBMISSION
COLPO BASSO=LOW_KICK
CONTRATTACCO*=COUNTER
MOVIM. SISMICO*=SEISMIC_TOSS
FORZA=STRENGTH
ASSORBIMENTO=ABSORB
MEGASSORBIMENTO*=MEGA_DRAIN
PARASSISEME=LEECH_SEED
CRESCITA=GROWTH
FOGLIELAMA=RAZOR_LEAF
SOLARRAGGIO=SOLARBEAM
VELENPOLVERE=POISONPOWDER
PARALIZZANTE=STUN_SPORE
SONNIFERO=SLEEP_POWDER
PETALODANZA=PETAL_DANCE
MILLEBAVE=STRING_SHOT
IRA DI DRAGO=DRAGON_RAGE
TURBOFUOCO=FIRE_SPIN
TUONOSHOCK=THUNDERSHOCK
FULMINE=THUNDERBOLT
TUONONDA=THUNDER_WAVE
TUONO=THUNDER
SASSATA=ROCK_THROW
TERREMOTO=EARTHQUAKE
ABISSO=FISSURE
FOSSA=DIG
TOSSINA=TOXIC
CONFUSIONE=CONFUSION
PSICHICO=PSYCHIC
IPNOSI=HYPNOSIS
MEDITAZIONE=MEDITATE
AGILITÀ=AGILITY
ATTACCO RAPIDO*=QUICK_ATTACK
IRA=RAGE
TELETRASPORTO*=TELEPORT
OMBRA NOTTURNA*=NIGHT_SHADE
MIMICA=MIMIC
STRIDIO=SCREECH
DOPPIOTEAM=DOUBLE_TEAM
RIPRESA=RECOVER
RAFFORZATORE=HARDEN
MINIMIZZATO=MINIMIZE
MURO DI FUMO=SMOKESCREEN
STORDIRAGGIO=CONFUSE_RAY
RITIRATA=WITHDRAW
RICCIOLSCUDO=DEFENSE_CURL
BARRIERA=BARRIER
SCHERMOLUCE=LIGHT_SCREEN
NUBE=HAZE
RIFLESSO=REFLECT
FOCALENERGIA*=FOCUS_ENERGY
PAZIENZA=BIDE
METRONOMO=METRONOME
SPECULMOSSA=MIRROR_MOVE
AUTODISTRUZIONE*=SELFDESTRUCT
UOVOBOMBA=EGG_BOMB
LECCATA=LICK
SMOG=SMOG
FANGO=SLUDGE
OSSOCLAVA=BONE_CLUB
FUOCOBOMBA=FIRE_BLAST
CASCATA=WATERFALL
TENAGLIA=CLAMP
COMETE=SWIFT
CAPOCCIATA=SKULL_BASH
SPARALANCE=SPIKE_CANNON
LIMITAZIONE=CONSTRICT
AMNESIA=AMNESIA
CINÈSI=KINESIS
COVAUOVA=SOFTBOILED
CALCINVOLO=HI_JUMP_KICK
SGUARDO FEROCE*=GLARE
MANGIASOGNI=DREAM_EATER
VELENOGAS=POISON_GAS
ATTACCO PIOGGIA*=BARRAGE
SANGUISUGA=LEECH_LIFE
DEMONBACIO=LOVELY_KISS
AEROATTACCO=SKY_ATTACK
TRASFORMAZIONE*=TRANSFORM
BOLLA=BUBBLE
STORDIPUGNO=DIZZY_PUNCH
SPORA=SPORE
FLASH=FLASH
PSICONDA*=PSYWAVE
SPLASH=SPLASH
SCUDO ACIDO=ACID_ARMOR
MARTELLATA=CRABHAMMER
ESPLOSIONE=EXPLOSION
SFURIATE=FURY_SWIPES
OSSOMERANG=BONEMERANG
RIPOSO=REST
FRANA=ROCK_SLIDE
IPERZANNA=HYPER_FANG
AFFILATORE=SHARPEN
CONVERSIONE=CONVERSION
TRIPLETTA=TRI_ATTACK
SUPERZANNA=SUPER_FANG
LACERAZIONE=SLASH
SOSTITUTO=SUBSTITUTE
SCONTRO=STRUGGLE
SCHIZZO=SKETCH
TRIPLOCALCIO=TRIPLE_KICK
FURTO=THIEF
RAGNATELA=SPIDER_WEB
LEGGIMENTE=MIND_READER
INCUBO=NIGHTMARE
RUOTAFUOCO=FLAME_WHEEL
RUSSARE=SNORE
MALEDIZIONE=CURSE
FLAGELLO=FLAIL
CONVERSIONE2=CONVERSION_2
AEROCOLPO=AEROBLAST
COTTONSPORA=COTTON_SPORE
CONTROPIEDE=REVERSAL
DISPETTO=SPITE
POLNEVE=POWDER_SNOW
PROTEZIONE=PROTECT
PUGNORAPIDO=MACH_PUNCH
VISOTRUCE=SCARY_FACE
FINTA=FAINT_ATTACK
DOLCEBACIO=SWEET_KISS
PANCIAMBURO=BELLY_DRUM
FANGOBOMBA=SLUDGE_BOMB
FANGOSBERLA=MUD_SLAP
OCTAZOOKA=OCTAZOOKA
PUNTE=SPIKES
FALCECANNONE=ZAP_CANNON
PREVEGGENZA=FORESIGHT
DESTINOBBLIGATO*=DESTINY_BOND
ULTIMOCANTO=PERISH_SONG
VENTOGELATO=ICY_WIND
INDIVIDUA=DETECT
OSSORAFFICA=BONE_RUSH
LOCALIZZA=LOCK_ON
OLTRAGGIO=OUTRAGE
TERREMPESTA=SANDSTORM
GIGASSORBIMENTO*=GIGA_DRAIN
RESISTENZA=ENDURE
FASCINO=CHARM
ROTOLAMENTO=ROLLOUT
FALSOFINALE=FALSE_SWIPE
BULLO=SWAGGER
BUONLATTE=MILK_DRINK
SCINTILLA=SPARK
TAGLIOFURIA=FURY_CUTTER
ALACCIAIO=STEEL_WING
MALOSGUARDO=MEAN_LOOK
ATTRAZIONE=ATTRACT
SONNOLALIA=SLEEP_TALK
RINTOCCASANA=HEAL_BELL
RITORNO=RETURN
REGALINO=PRESENT
FRUSTRAZIONE=FRUSTRATION
SALVAGUARDIA=SAFEGUARD
MALCOMUNE=PAIN_SPLIT
MAGIFUOCO=SACRED_FIRE
MAGNITUDO=MAGNITUDE
DINAMIPUGNO=DYNAMICPUNCH
MEGACORNO=MEGAHORN
DRAGOSPIRO=DRAGONBREATH
STAFFETTA=BATON_PASS
RIPETI=ENCORE
INSEGUIMENTO=PURSUIT
RAPIGIRO=RAPID_SPIN
PROFUMINO=SWEET_SCENT
CODACCIAIO=IRON_TAIL
FERRARTIGLI=METAL_CLAW
VITALTIRO=VITAL_THROW
MATTINDORO=MORNING_SUN
SINTESI=SYNTHESIS
LUCELUNARE=MOONLIGHT
INTROFORZA=HIDDEN_POWER
INCROCOLPO=CROSS_CHOP
TORNADO=TWISTER
PIOGGIADANZA=RAIN_DANCE
GIORNODISOLE=SUNNY_DAY
SGRANOCCHIO=CRUNCH
SPECCHIOVELO=MIRROR_COAT
PSICAMISÙ=PSYCH_UP
EXTRARAPIDO=EXTREMESPEED
FORZANTICA=ANCIENTPOWER
PALLA OMBRA=SHADOW_BALL
DIVINAZIONE=FUTURE_SIGHT
SPACCAROCCIA=ROCK_SMASH
MULINELLO=WHIRLPOOL
PICCHIADURO=BEAT_UP
BRUCIAPELO=FAKE_OUT
BARAONDA=UPROAR
ACCUMULO=STOCKPILE
SFOGHENERGIA=SPIT_UP
INTOENERGIA=SWALLOW
ONDACALDA=HEAT_WAVE
GRANDINE=HAIL
ATTACCALITE=TORMENT
ADULAZIONE=FLATTER
FUOCOFATUO=WILL_O_WISP
MEMENTO=MEMENTO
FACCIATA=FACADE
CENTRIPUGNO=FOCUS_PUNCH
MANIEREFORTI=SMELLINGSALT
SONOQUI=FOLLOW_ME
NATURFORZA=NATURE_POWER
SOTTOCARICA=CHARGE
PROVOCAZIONE=TAUNT
ALTRUISMO=HELPING_HAND
RAGGIRO=TRICK
GIOCODIRUOLO=ROLE_PLAY
DESIDERIO=WISH
ASSISTENTE=ASSIST
RADICAMENTO=INGRAIN
TROPPOFORTE=SUPERPOWER
MAGIVELO=MAGIC_COAT
RICICLO=RECYCLE
VENDETTA=REVENGE
BRECCIA=BRICK_BREAK
SBADIGLIO=YAWN
PRIVAZIONE=KNOCK_OFF
RIMONTA=ENDEAVOR
ERUZIONE=ERUPTION
BARATTO=SKILL_SWAP
ESCLUSIVA=IMPRISON
RINFRESCATA=REFRESH
RANCORE=GRUDGE
SCIPPO=SNATCH
FORZASEGRETA=SECRET_POWER
SUB=DIVE
SBERLETESE=ARM_THRUST
CAMUFFAMENTO=CAMOUFLAGE
CODADILUCE=TAIL_GLOW
ABBAGLIANTE=LUSTER_PURGE
FOSCHISFERA=MIST_BALL
DANZADIPIUME=FEATHERDANCE
STRAMPADANZA=TEETER_DANCE
CALCIARDENTE=BLAZE_KICK
FANGATA=MUD_SPORT
PALLA GELO=ICE_BALL
PUGNOSPINE=NEEDLE_ARM
PIGRO=SLACK_OFF
GRANVOCE=HYPER_VOICE
VELENODENTI=POISON_FANG
TRITARTIGLI=CRUSH_CLAW
INCENDIO=BLAST_BURN
IDROCANNONE=HYDRO_CANNON
METEORPUGNO=METEOR_MASH
SGOMENTO=ASTONISH
PALLA CLIMA=WEATHER_BALL
AROMATERAPIA=AROMATHERAPY
FALSELACRIME=FAKE_TEARS
AERASOIO=AIR_CUTTER
VAMPATA=OVERHEAT
SEGUGIO=ODOR_SLEUTH
ROCCIOTOMBA=ROCK_TOMB
VENTARGENTEO=SILVER_WIND
FERROSTRIDO=METAL_SOUND
MELODERBA=GRASSWHISTLE
SOLLETICO=TICKLE
COSMOFORZA=COSMIC_POWER
ZAMPILLO=WATER_SPOUT
SEGNORAGGIO=SIGNAL_BEAM
PUGNODOMBRA=SHADOW_PUNCH
EXTRASENSO=EXTRASENSORY
STRAMONTANTE=SKY_UPPERCUT
SABBIOTOMBA=SAND_TOMB
PUROGELO=SHEER_COLD
FANGHIGLIA=MUDDY_WATER
SEMITRAGLIA=BULLET_SEED
AEROASSALTO=AERIAL_ACE
GELOLANCIA=ICICLE_SPEAR
FERROSCUDO=IRON_DEFENSE
BLOCCO=BLOCK
GRIDODILOTTA=HOWL
DRAGARTIGLI=DRAGON_CLAW
RADICALBERO=FRENZY_PLANT
GRANFISICO=BULK_UP
RIMBALZO=BOUNCE
COLPODIFANGO=MUD_SHOT
VELENOCODA=POISON_TAIL
SUPPLICA=COVET
LOCOMOVOLT=VOLT_TACKLE
FOGLIAMAGICA=MAGICAL_LEAF
DOCCIASCUDO=WATER_SPORT
CALMAMENTE=CALM_MIND
FENDIFOGLIA=LEAF_BLADE
DRAGODANZA=DRAGON_DANCE
CADUTAMASSI=ROCK_BLAST
ONDASHOCK=SHOCK_WAVE
IDROPULSAR=WATER_PULSE
OBBLIDERIO=DOOM_DESIRE
PSICOSLANCIO=PSYCHO_BOOST