----------=----------
フシギダネ=フシギダネ
フシギソウ=フシギソウ
フシギバナ=フシギバナ
ヒトカゲ=ヒトカゲ
リザード=リザード
リザードン=リザードン
ゼニガメ=ゼニガメ
カメール=カメール
カメックス=カメックス
キャタピー=キャタピー
トランセル=トランセル
バタフリー=バタフリー
ビードル=ビードル
コクーン=コクーン
スピアー=スピアー
ポッポ=ポッポ
ピジョン=ピジョン
ピジョット=ピジョット
コラッタ=コラッタ
ラッタ=ラッタ
オニスズメ=オニスズメ
オニドリル=オニドリル
アーボ=アーボ
アーボック=アーボック
ピカチュウ=ピカチュウ
ライチュウ=ライチュウ
サンド=サンド
サンドパン=サンドパン
ニドラン♀=ニドラン♀
ニドリーナ=ニドリーナ
ニドクイン=ニドクイン
ニドラン♂=ニドラン♂
ニドリーノ=ニドリーノ
ニドキング=ニドキング
ピッピ=ピッピ
ピクシー=ピクシー
ロコン=ロコン
キュウコン=キュウコン
プリン=プリン
プクリン=プクリン
ズバット=ズバット
ゴルバット=ゴルバット
ナゾノクサ=ナゾノクサ
クサイハナ=クサイハナ
ラフレシア=ラフレシア
パラス=パラス
パラセクト=パラセクト
コンパン=コンパン
モルフォン=モルフォン
ディグダ=ディグダ
ダグトリオ=ダグトリオ
ニャース=ニャース
ペルシアン=ペルシアン
コダック=コダック
ゴルダック=ゴルダック
マンキー=マンキー
オコリザル=オコリザル
ガーディ=ガーディ
ウインディ=ウインディ
ニョロモ=ニョロモ
ニョロゾ=ニョロゾ
ニョロボン=ニョロボン
ケーシィ=ケーシィ
ユンゲラー=ユンゲラー
フーディン=フーディン
ワンリキー=ワンリキー
ゴーリキー=ゴーリキー
カイリキー=カイリキー
マダツボミ=マダツボミ
ウツドン=ウツドン
ウツボット=ウツボット
メノクラゲ=メノクラゲ
ドククラゲ=ドククラゲ
イシツブテ=イシツブテ
ゴローン=ゴローン
ゴローニャ=ゴローニャ
ポニータ=ポニータ
ギャロップ=ギャロップ
ヤドン=ヤドン
ヤドラン=ヤドラン
コイル=コイル
レアコイル=レアコイル
カモネギ=カモネギ
ドードー=ドードー
ドードリオ=ドードリオ
パウワウ=パウワウ
ジュゴン=ジュゴン
ベトベター=ベトベター
ベトベトン=ベトベトン
シェルダー=シェルダー
パルシェン=パルシェン
ゴース=ゴース
ゴースト=ゴースト
ゲンガー=ゲンガー
イワーク=イワーク
スリープ=スリープ
スリーパー=スリーパー
クラブ=クラブ
キングラー=キングラー
ビリリダマ=ビリリダマ
マルマイン=マルマイン
タマタマ=タマタマ
ナッシー=ナッシー
カラカラ=カラカラ
ガラガラ=ガラガラ
サワムラー=サワムラー
エビワラー=エビワラー
ベロリンガ=ベロリンガ
ドガース=ドガース
マタドガス=マタドガス
サイホーン=サイホーン
サイドン=サイドン
ラッキー=ラッキー
モンジャラ=モンジャラ
ガルーラ=ガルーラ
タッツー=タッツー
シードラ=シードラ
トサキント=トサキント
アズマオウ=アズマオウ
ヒトデマン=ヒトデマン
スターミー=スターミー
バリヤード=バリヤード
ストライク=ストライク
ルージュラ=ルージュラ
エレブー=エレブー
ブーバー=ブーバー
カイロス=カイロス
ケンタロス=ケンタロス
コイキング=コイキング
ギャラドス=ギャラドス
ラプラス=ラプラス
メタモン=メタモン
イーブイ=イーブイ
シャワーズ=シャワーズ
サンダース=サンダース
ブースター=ブースター
ポリゴン=ポリゴン
オムナイト=オムナイト
オムスター=オムスター
カブト=カブト
カブトプス=カブトプス
プテラ=プテラ
カビゴン=カビゴン
フリーザー=フリーザー
サンダー=サンダー
ファイヤー=ファイヤー
ミニリュウ=ミニリュウ
ハクリュー=ハクリュー
カイリュー=カイリュー
ミュウツー=ミュウツー
ミュウ=ミュウ
チコリータ=チコリータ
ベイリーフ=ベイリーフ
メガニウム=メガニウム
ヒノアラシ=ヒノアラシ
マグマラシ=マグマラシ
バクフーン=バクフーン
ワニノコ=ワニノコ
アリゲイツ=アリゲイツ
オーダイル=オーダイル
オタチ=オタチ
オオタチ=オオタチ
ホーホー=ホーホー
ヨルノズク=ヨルノズク
レディバ=レディバ
レディアン=レディアン
イトマル=イトマル
アリアドス=アリアドス
クロバット=クロバット
チョンチー=チョンチー
ランターン=ランターン
ピチュー=ピチュー
ピィ=ピィ
ププリン=ププリン
トゲピー=トゲピー
トゲチック=トゲチック
ネイティ=ネイティ
ネイティオ=ネイティオ
メリープ=メリープ
モココ=モココ
デンリュウ=デンリュウ
キレイハナ=キレイハナ
マリル=マリル
マリルリ=マリルリ
ウソッキー=ウソッキー
ニョロトノ=ニョロトノ
ハネッコ=ハネッコ
ポポッコ=ポポッコ
ワタッコ=ワタッコ
エイパム=エイパム
ヒマナッツ=ヒマナッツ
キマワリ=キマワリ
ヤンヤンマ=ヤンヤンマ
ウパー=ウパー
ヌオー=ヌオー
エーフィ=エーフィ
ブラッキー=ブラッキー
ヤミカラス=ヤミカラス
ヤドキング=ヤドキング
ムウマ=ムウマ
アンノーン=アンノーン
ソーナンス=ソーナンス
キリンリキ=キリンリキ
クヌギダマ=クヌギダマ
フォレトス=フォレトス
ノコッチ=ノコッチ
グライガー=グライガー
ハガネール=ハガネール
ブルー=ブルー
グランブル=グランブル
ハリーセン=ハリーセン
ハッサム=ハッサム
ツボツボ=ツボツボ
ヘラクロス=ヘラクロス
ニューラ=ニューラ
ヒメグマ=ヒメグマ
リングマ=リングマ
マグマッグ=マグマッグ
マグカルゴ=マグカルゴ
ウリムー=ウリムー
イノムー=イノムー
サニーゴ=サニーゴ
テッポウオ=テッポウオ
オクタン=オクタン
デリバード=デリバード
マンタイン=マンタイン
エアームド=エアームド
デルビル=デルビル
ヘルガー=ヘルガー
キングドラ=キングドラ
ゴマゾウ=ゴマゾウ
ドンファン=ドンファン
ポリゴン２=ポリゴン２
オドシシ=オドシシ
ドーブル=ドーブル
バルキー=バルキー
カポエラー=カポエラー
ムチュール=ムチュール
エレキッド=エレキッド
ブビィ=ブビィ
ミルタンク=ミルタンク
ハピナス=ハピナス
ライコウ=ライコウ
エンテイ=エンテイ
スイクン=スイクン
ヨーギラス=ヨーギラス
サナギラス=サナギラス
バンギラス=バンギラス
ルギア=ルギア
ホウオウ=ホウオウ
セレビィ=セレビィ
キモリ=キモリ
ジュプトル=ジュプトル
ジュカイン=ジュカイン
アチャモ=アチャモ
ワカシャモ=ワカシャモ
バシャーモ=バシャーモ
ミズゴロウ=ミズゴロウ
ヌマクロー=ヌマクロー
ラグラージ=ラグラージ
ポチエナ=ポチエナ
グラエナ=グラエナ
ジグザグマ=ジグザグマ
マッスグマ=マッスグマ
ケムッソ=ケムッソ
カラサリス=カラサリス
アゲハント=アゲハント
マユルド=マユルド
ドクケイル=ドクケイル
ハスボー=ハスボー
ハスブレロ=ハスブレロ
ルンパッパ=ルンパッパ
タネボー=タネボー
コノハナ=コノハナ
ダーテング=ダーテング
スバメ=スバメ
オオスバメ=オオスバメ
キャモメ=キャモメ
ペリッパー=ペリッパー
ラルトス=ラルトス
キルリア=キルリア
サーナイト=サーナイト
アメタマ=アメタマ
アメモース=アメモース
キノココ=キノココ
キノガッサ=キノガッサ
ナマケロ=ナマケロ
ヤルキモノ=ヤルキモノ
ケッキング=ケッキング
ツチニン=ツチニン
テッカニン=テッカニン
ヌケニン=ヌケニン
ゴニョニョ=ゴニョニョ
ドゴーム=ドゴーム
バクオング=バクオング
マクノシタ=マクノシタ
ハリテヤマ=ハリテヤマ
ルリリ=ルリリ
ノズパス=ノズパス
エネコ=エネコ
エネコロロ=エネコロロ
ヤミラミ=ヤミラミ
クチート=クチート
ココドラ=ココドラ
コドラ=コドラ
ボスゴドラ=ボスゴドラ
アサナン=アサナン
チャーレム=チャーレム
ラクライ=ラクライ
ライボルト=ライボルト
プラスル=プラスル
マイナン=マイナン
バルビート=バルビート
イルミーゼ=イルミーゼ
ロゼリア=ロゼリア
ゴクリン=ゴクリン
マルノーム=マルノーム
キバニア=キバニア
サメハダー=サメハダー
ホエルコ=ホエルコ
ホエルオー=ホエルオー
ドンメル=ドンメル
バクーダ=バクーダ
コータス=コータス
バネブー=バネブー
ブーピッグ=ブーピッグ
パッチール=パッチール
ナックラー=ナックラー
ビブラーバ=ビブラーバ
フライゴン=フライゴン
サボネア=サボネア
ノクタス=ノクタス
チルット=チルット
チルタリス=チルタリス
ザングース=ザングース
ハブネーク=ハブネーク
ルナトーン=ルナトーン
ソルロック=ソルロック
ドジョッチ=ドジョッチ
ナマズン=ナマズン
ヘイガニ=ヘイガニ
シザリガー=シザリガー
ヤジロン=ヤジロン
ネンドール=ネンドール
リリーラ=リリーラ
ユレイドル=ユレイドル
アノプス=アノプス
アーマルド=アーマルド
ヒンバス=ヒンバス
ミロカロス=ミロカロス
ポワルン=ポワルン
カクレオン=カクレオン
カゲボウズ=カゲボウズ
ジュペッタ=ジュペッタ
ヨマワル=ヨマワル
サマヨール=サマヨール
トロピウス=トロピウス
チリーン=チリーン
アブソル=アブソル
ソーナノ=ソーナノ
ユキワラシ=ユキワラシ
オニゴーリ=オニゴーリ
タマザラシ=タマザラシ
トドグラー=トドグラー
トドゼルガ=トドゼルガ
パールル=パールル
ハンテール=ハンテール
サクラビス=サクラビス
ジーランス=ジーランス
ラブカス=ラブカス
タツベイ=タツベイ
コモルー=コモルー
ボーマンダ=ボーマンダ
ダンバル=ダンバル
メタング=メタング
メタグロス=メタグロス
レジロック=レジロック
レジアイス=レジアイス
レジスチル=レジスチル
ラティアス=ラティアス
ラティオス=ラティオス
カイオーガ=カイオーガ
グラードン=グラードン
レックウザ=レックウザ
ジラーチ=ジラーチ
デオキシス=デオキシス