----------=----------
BULBIZARRE=BULBIZARRE
HERBIZARRE=HERBIZARRE
FLORIZARRE=FLORIZARRE
SALAMECHE=SALAMECHE
REPTINCEL=REPTINCEL
DRACAUFEU=DRACAUFEU
CARAPUCE=CARAPUCE
CARABAFFE=CARABAFFE
TORTANK=TORTANK
CHENIPAN=CHENIPAN
CHRYSACIER=CHRYSACIER
PAPILUSION=PAPILUSION
ASPICOT=ASPICOT
COCONFORT=COCONFORT
DARDAGNAN=DARDAGNAN
ROUCOOL=ROUCOOL
ROUCOUPS=ROUCOUPS
ROUCARNAGE=ROUCARNAGE
RATTATA=RATTATA
RATTATAC=RATTATAC
PIAFABEC=PIAFABEC
RAPASDEPIC=RAPASDEPIC
ABO=ABO
ARBOK=ARBOK
PIKACHU=PIKACHU
RAICHU=RAICHU
SABELETTE=SABELETTE
SABLAIREAU=SABLAIREAU
NIDORAN♀=NIDORAN♀
NIDORINA=NIDORINA
NIDOQUEEN=NIDOQUEEN
NIDORAN♂=NIDORAN♂
NIDORINO=NIDORINO
NIDOKING=NIDOKING
MELOFEE=MELOFEE
MELODELFE=MELODELFE
GOUPIX=GOUPIX
FEUNARD=FEUNARD
RONDOUDOU=RONDOUDOU
GRODOUDOU=GRODOUDOU
NOSFERAPTI=NOSFERAPTI
NOSFERALTO=NOSFERALTO
MYSTHERBE=MYSTHERBE
ORTIDE=ORTIDE
RAFFLESIA=RAFFLESIA
PARAS=PARAS
PARASECT=PARASECT
MIMITOSS=MIMITOSS
AEROMITE=AEROMITE
TAUPIQUEUR=TAUPIQUEUR
TRIOPIQUEUR=TRIOPIQUEUR
MIAOUSS=MIAOUSS
PERSIAN=PERSIAN
PSYKOKWAK=PSYKOKWAK
AKWAKWAK=AKWAKWAK
FEROSINGE=FEROSINGE
COLOSSINGE=COLOSSINGE
CANINOS=CANINOS
ARCANIN=ARCANIN
PTITART=PTITART
TETARTE=TETARTE
TARTARD=TARTARD
ABRA=ABRA
KADABRA=KADABRA
ALAKAZAM=ALAKAZAM
MACHOC=MACHOC
MACHOPEUR=MACHOPEUR
MACKOGNEUR=MACKOGNEUR
CHETIFLOR=CHETIFLOR
BOUSTIFLOR=BOUSTIFLOR
EMPIFLOR=EMPIFLOR
TENTACOOL=TENTACOOL
TENTACRUEL=TENTACRUEL
RACAILLOU=RACAILLOU
GRAVALANCH=GRAVALANCH
GROLEM=GROLEM
PONYTA=PONYTA
GALOPA=GALOPA
RAMOLOSS=RAMOLOSS
FLAGADOSS=FLAGADOSS
MAGNETI=MAGNETI
MAGNETON=MAGNETON
CANARTICHO=CANARTICHO
DODUO=DODUO
DODRIO=DODRIO
OTARIA=OTARIA
LAMANTINE=LAMANTINE
TADMORV=TADMORV
GROTADMORV=GROTADMORV
KOKIYAS=KOKIYAS
CRUSTABRI=CRUSTABRI
FANTOMINUS=FANTOMINUS
SPECTRUM=SPECTRUM
ECTOPLASMA=ECTOPLASMA
ONIX=ONIX
SOPORIFIK=SOPORIFIK
HYPNOMADE=HYPNOMADE
KRABBY=KRABBY
KRABBOSS=KRABBOSS
VOLTORBE=VOLTORBE
ELECTRODE=ELECTRODE
NOEUNOEUF=NOEUNOEUF
NOADKOKO=NOADKOKO
OSSELAIT=OSSELAIT
OSSATUEUR=OSSATUEUR
KICKLEE=KICKLEE
TYGNON=TYGNON
EXCELANGUE=EXCELANGUE
SMOGO=SMOGO
SMOGOGO=SMOGOGO
RHINOCORNE=RHINOCORNE
RHINOFEROS=RHINOFEROS
LEVEINARD=LEVEINARD
SAQUEDENEU=SAQUEDENEU
KANGOUREX=KANGOUREX
HYPOTREMPE=HYPOTREMPE
HYPOCEAN=HYPOCEAN
POISSIRENE=POISSIRENE
POISSOROY=POISSOROY
STARI=STARI
STAROSS=STAROSS
M.MIME=M_MIME
INSECATEUR=INSECATEUR
LIPPOUTOU=LIPPOUTOU
ELECTEK=ELECTEK
MAGMAR=MAGMAR
SCARABRUTE=SCARABRUTE
TAUROS=TAUROS
MAGICARP=MAGICARP
LEVIATOR=LEVIATOR
LOKHLASS=LOKHLASS
METAMORPHE=METAMORPHE
EVOLI=EVOLI
AQUALI=AQUALI
VOLTALI=VOLTALI
PYROLI=PYROLI
PORYGON=PORYGON
AMONITA=AMONITA
AMONISTAR=AMONISTAR
KABUTO=KABUTO
KABUTOPS=KABUTOPS
PTERA=PTERA
RONFLEX=RONFLEX
ARTIKODIN=ARTIKODIN
ELECTHOR=ELECTHOR
SULFURA=SULFURA
MINIDRACO=MINIDRACO
DRACO=DRACO
DRACOLOSSE=DRACOLOSSE
MEWTWO=MEWTWO
MEW=MEW
GERMIGNON=GERMIGNON
MACRONIUM=MACRONIUM
MEGANIUM=MEGANIUM
HERICENDRE=HERICENDRE
FEURISSON=FEURISSON
TYPHLOSION=TYPHLOSION
KAIMINUS=KAIMINUS
CROCRODIL=CROCRODIL
ALIGATUEUR=ALIGATUEUR
FOUINETTE=FOUINETTE
FOUINAR=FOUINAR
HOOTHOOT=HOOTHOOT
NOARFANG=NOARFANG
COXY=COXY
COXYCLAQUE=COXYCLAQUE
MIMIGAL=MIMIGAL
MIGALOS=MIGALOS
NOSTENFER=NOSTENFER
LOUPIO=LOUPIO
LANTURN=LANTURN
PICHU=PICHU
MELO=MELO
TOUDOUDOU=TOUDOUDOU
TOGEPI=TOGEPI
TOGETIC=TOGETIC
NATU=NATU
XATU=XATU
WATTOUAT=WATTOUAT
LAINERGIE=LAINERGIE
PHARAMP=PHARAMP
JOLIFLOR=JOLIFLOR
MARILL=MARILL
AZUMARILL=AZUMARILL
SIMULARBRE=SIMULARBRE
TARPAUD=TARPAUD
GRANIVOL=GRANIVOL
FLORAVOL=FLORAVOL
COTOVOL=COTOVOL
CAPUMAIN=CAPUMAIN
TOURNEGRIN=TOURNEGRIN
HELIATRONC=HELIATRONC
YANMA=YANMA
AXOLOTO=AXOLOTO
MARAISTE=MARAISTE
MENTALI=MENTALI
NOCTALI=NOCTALI
CORNEBRE=CORNEBRE
ROIGADA=ROIGADA
FEUFOREVE=FEUFOREVE
ZARBI=ZARBI
QULBUTOKE=QULBUTOKE
GIRAFARIG=GIRAFARIG
POMDEPIC=POMDEPIC
FORETRESS=FORETRESS
INSOLOURDO=INSOLOURDO
SCORPLANE=SCORPLANE
STEELIX=STEELIX
SNUBBULL=SNUBBULL
GRANBULL=GRANBULL
QWILFISH=QWILFISH
CIZAYOX=CIZAYOX
CARATROC=CARATROC
SCARHINO=SCARHINO
FARFURET=FARFURET
TEDDIURSA=TEDDIURSA
URSARING=URSARING
LIMAGNA=LIMAGNA
VOLCAROPOD=VOLCAROPOD
MARCACRIN=MARCACRIN
COCHIGNON=COCHIGNON
CORAYON=CORAYON
REMORAID=REMORAID
OCTILLERY=OCTILLERY
CADOIZO=CADOIZO
DEMANTA=DEMANTA
AIRMURE=AIRMURE
MALOSSE=MALOSSE
DEMOLOSSE=DEMOLOSSE
HYPOROI=HYPOROI
PHANPY=PHANPY
DONPHAN=DONPHAN
PORYGON2=PORYGON2
CERFROUSSE=CERFROUSSE
QUEULORIOR=QUEULORIOR
DEBUGANT=DEBUGANT
KAPOERA=KAPOERA
LIPPOUTI=LIPPOUTI
ELEKID=ELEKID
MAGBY=MAGBY
ECREMEUH=ECREMEUH
LEUPHORIE=LEUPHORIE
RAIKOU=RAIKOU
ENTEI=ENTEI
SUICUNE=SUICUNE
EMBRYLEX=EMBRYLEX
YMPHECT=YMPHECT
TYRANOCIF=TYRANOCIF
LUGIA=LUGIA
HO-OH=HO-OH
CELEBI=CELEBI
ARCKO=ARCKO
MASSKO=MASSKO
JUNGKO=JUNGKO
POUSSIFEU=POUSSIFEU
GALIFEU=GALIFEU
BRASEGALI=BRASEGALI
GOBOU=GOBOU
FLOBIO=FLOBIO
LAGGRON=LAGGRON
MEDHYENA=MEDHYENA
GRAHYENA=GRAHYENA
ZIGZATON=ZIGZATON
LINEON=LINEON
CHENIPOTTE=CHENIPOTTE
ARMULYS=ARMULYS
CHARMILLON=CHARMILLON
BLINDALYS=BLINDALYS
PAPINOX=PAPINOX
NENUPIOT=NENUPIOT
LOMBRE=LOMBRE
LUDICOLO=LUDICOLO
GRAINIPIOT=GRAINIPIOT
PIFEUIL=PIFEUIL
TENGALICE=TENGALICE
NIRONDELLE=NIRONDELLE
HELEDELLE=HELEDELLE
GOELISE=GOELISE
BEKIPAN=BEKIPAN
TARSAL=TARSAL
KIRLIA=KIRLIA
GARDEVOIR=GARDEVOIR
ARAKDO=ARAKDO
MASKADRA=MASKADRA
BALIGNON=BALIGNON
CHAPIGNON=CHAPIGNON
PARECOOL=PARECOOL
VIGOROTH=VIGOROTH
MONAFLEMIT=MONAFLEMIT
NINGALE=NINGALE
NINJASK=NINJASK
MUNJA=MUNJA
CHUCHMUR=CHUCHMUR
RAMBOUM=RAMBOUM
BROUHABAM=BROUHABAM
MAKUHITA=MAKUHITA
HARIYAMA=HARIYAMA
AZURILL=AZURILL
TARINOR=TARINOR
SKITTY=SKITTY
DELCATTY=DELCATTY
TENEFIX=TENEFIX
MYSDIBULE=MYSDIBULE
GALEKID=GALEKID
GALEGON=GALEGON
GALEKING=GALEKING
MEDITIKKA=MEDITIKKA
CHARMINA=CHARMINA
DYNAVOLT=DYNAVOLT
ELECSPRINT=ELECSPRINT
POSIPI=POSIPI
NEGAPI=NEGAPI
MUCIOLE=MUCIOLE
LUMIVOLE=LUMIVOLE
ROSELIA=ROSELIA
GLOUPTI=GLOUPTI
AVALTOUT=AVALTOUT
CARVANHA=CARVANHA
SHARPEDO=SHARPEDO
WAILMER=WAILMER
WAILORD=WAILORD
CHAMALLOT=CHAMALLOT
CAMERUPT=CAMERUPT
CHARTOR=CHARTOR
SPOINK=SPOINK
GRORET=GRORET
SPINDA=SPINDA
KRAKNOIX=KRAKNOIX
VIBRANINF=VIBRANINF
LIBEGON=LIBEGON
CACNEA=CACNEA
CACTURNE=CACTURNE
TYLTON=TYLTON
ALTARIA=ALTARIA
MANGRIFF=MANGRIFF
SEVIPER=SEVIPER
SELEROC=SELEROC
SOLAROC=SOLAROC
BARLOCHE=BARLOCHE
BARBICHA=BARBICHA
ECRAPINCE=ECRAPINCE
COLHOMARD=COLHOMARD
BALBUTO=BALBUTO
KAORINE=KAORINE
LILIA=LILIA
VACILYS=VACILYS
ANORITH=ANORITH
ARMALDO=ARMALDO
BARPAU=BARPAU
MILOBELLUS=MILOBELLUS
MORPHEO=MORPHEO
KECLEON=KECLEON
POLICHOMBR=POLICHOMBR
BRANETTE=BRANETTE
SKELENOX=SKELENOX
TERACLOPE=TERACLOPE
TROPIUS=TROPIUS
EOKO=EOKO
ABSOL=ABSOL
OKEOKE=OKEOKE
STALGAMIN=STALGAMIN
ONIGLALI=ONIGLALI
OBALIE=OBALIE
PHOGLEUR=PHOGLEUR
KAIMORSE=KAIMORSE
COQUIPERL=COQUIPERL
SERPANG=SERPANG
ROSABYSS=ROSABYSS
RELICANTH=RELICANTH
LOVDISC=LOVDISC
DRABY=DRABY
DRACKHAUS=DRACKHAUS
DRATTAK=DRATTAK
TERHAL=TERHAL
METANG=METANG
METALOSSE=METALOSSE
REGIROCK=REGIROCK
REGICE=REGICE
REGISTEEL=REGISTEEL
LATIAS=LATIAS
LATIOS=LATIOS
KYOGRE=KYOGRE
GROUDON=GROUDON
RAYQUAZA=RAYQUAZA
JIRACHI=JIRACHI
DEOXYS=DEOXYS