----------=----------
BULBASAUR=BULBASAUR
IVYSAUR=IVYSAUR
VENUSAUR=VENUSAUR
CHARMANDER=CHARMANDER
CHARMELEON=CHARMELEON
CHARIZARD=CHARIZARD
SQUIRTLE=SQUIRTLE
WARTORTLE=WARTORTLE
BLASTOISE=BLASTOISE
CATERPIE=CATERPIE
METAPOD=METAPOD
BUTTERFREE=BUTTERFREE
WEEDLE=WEEDLE
KAKUNA=KAKUNA
BEEDRILL=BEEDRILL
PIDGEY=PIDGEY
PIDGEOTTO=PIDGEOTTO
PIDGEOT=PIDGEOT
RATTATA=RATTATA
RATICATE=RATICATE
SPEAROW=SPEAROW
FEAROW=FEAROW
EKANS=EKANS
ARBOK=ARBOK
PIKACHU=PIKACHU
RAICHU=RAICHU
SANDSHREW=SANDSHREW
SANDSLASH=SANDSLASH
NIDORAN♀=NIDORAN_F
NIDORINA=NIDORINA
NIDOQUEEN=NIDOQUEEN
NIDORAN♂=NIDORAN_M
NIDORINO=NIDORINO
NIDOKING=NIDOKING
CLEFAIRY=CLEFAIRY
CLEFABLE=CLEFABLE
VULPIX=VULPIX
NINETALES=NINETALES
JIGGLYPUFF=JIGGLYPUFF
WIGGLYTUFF=WIGGLYTUFF
ZUBAT=ZUBAT
GOLBAT=GOLBAT
ODDISH=ODDISH
GLOOM=GLOOM
VILEPLUME=VILEPLUME
PARAS=PARAS
PARASECT=PARASECT
VENONAT=VENONAT
VENOMOTH=VENOMOTH
DIGLETT=DIGLETT
DUGTRIO=DUGTRIO
MEOWTH=MEOWTH
PERSIAN=PERSIAN
PSYDUCK=PSYDUCK
GOLDUCK=GOLDUCK
MANKEY=MANKEY
PRIMEAPE=PRIMEAPE
GROWLITHE=GROWLITHE
ARCANINE=ARCANINE
POLIWAG=POLIWAG
POLIWHIRL=POLIWHIRL
POLIWRATH=POLIWRATH
ABRA=ABRA
KADABRA=KADABRA
ALAKAZAM=ALAKAZAM
MACHOP=MACHOP
MACHOKE=MACHOKE
MACHAMP=MACHAMP
BELLSPROUT=BELLSPROUT
WEEPINBELL=WEEPINBELL
VICTREEBEL=VICTREEBEL
TENTACOOL=TENTACOOL
TENTACRUEL=TENTACRUEL
GEODUDE=GEODUDE
GRAVELER=GRAVELER
GOLEM=GOLEM
PONYTA=PONYTA
RAPIDASH=RAPIDASH
SLOWPOKE=SLOWPOKE
SLOWBRO=SLOWBRO
MAGNEMITE=MAGNEMITE
MAGNETON=MAGNETON
FARFETCH'D=FARFETCH_D
DODUO=DODUO
DODRIO=DODRIO
SEEL=SEEL
DEWGONG=DEWGONG
GRIMER=GRIMER
MUK=MUK
SHELLDER=SHELLDER
CLOYSTER=CLOYSTER
GASTLY=GASTLY
HAUNTER=HAUNTER
GENGAR=GENGAR
ONIX=ONIX
DROWZEE=DROWZEE
HYPNO=HYPNO
KRABBY=KRABBY
KINGLER=KINGLER
VOLTORB=VOLTORB
ELECTRODE=ELECTRODE
EXEGGCUTE=EXEGGCUTE
EXEGGUTOR=EXEGGUTOR
CUBONE=CUBONE
MAROWAK=MAROWAK
HITMONLEE=HITMONLEE
HITMONCHAN=HITMONCHAN
LICKITUNG=LICKITUNG
KOFFING=KOFFING
WEEZING=WEEZING
RHYHORN=RHYHORN
RHYDON=RHYDON
CHANSEY=CHANSEY
TANGELA=TANGELA
KANGASKHAN=KANGASKHAN
HORSEA=HORSEA
SEADRA=SEADRA
GOLDEEN=GOLDEEN
SEAKING=SEAKING
STARYU=STARYU
STARMIE=STARMIE
MR. MIME=MR_MIME
SCYTHER=SCYTHER
JYNX=JYNX
ELECTABUZZ=ELECTABUZZ
MAGMAR=MAGMAR
PINSIR=PINSIR
TAUROS=TAUROS
MAGIKARP=MAGIKARP
GYARADOS=GYARADOS
LAPRAS=LAPRAS
DITTO=DITTO
EEVEE=EEVEE
VAPOREON=VAPOREON
JOLTEON=JOLTEON
FLAREON=FLAREON
PORYGON=PORYGON
OMANYTE=OMANYTE
OMASTAR=OMASTAR
KABUTO=KABUTO
KABUTOPS=KABUTOPS
AERODACTYL=AERODACTYL
SNORLAX=SNORLAX
ARTICUNO=ARTICUNO
ZAPDOS=ZAPDOS
MOLTRES=MOLTRES
DRATINI=DRATINI
DRAGONAIR=DRAGONAIR
DRAGONITE=DRAGONITE
MEWTWO=MEWTWO
MEW=MEW
CHIKORITA=CHIKORITA
BAYLEEF=BAYLEEF
MEGANIUM=MEGANIUM
CYNDAQUIL=CYNDAQUIL
QUILAVA=QUILAVA
TYPHLOSION=TYPHLOSION
TOTODILE=TOTODILE
CROCONAW=CROCONAW
FERALIGATR=FERALIGATR
SENTRET=SENTRET
FURRET=FURRET
HOOTHOOT=HOOTHOOT
NOCTOWL=NOCTOWL
LEDYBA=LEDYBA
LEDIAN=LEDIAN
SPINARAK=SPINARAK
ARIADOS=ARIADOS
CROBAT=CROBAT
CHINCHOU=CHINCHOU
LANTURN=LANTURN
PICHU=PICHU
CLEFFA=CLEFFA
IGGLYBUFF=IGGLYBUFF
TOGEPI=TOGEPI
TOGETIC=TOGETIC
NATU=NATU
XATU=XATU
MAREEP=MAREEP
FLAAFFY=FLAAFFY
AMPHAROS=AMPHAROS
BELLOSSOM=BELLOSSOM
MARILL=MARILL
AZUMARILL=AZUMARILL
SUDOWOODO=SUDOWOODO
POLITOED=POLITOED
HOPPIP=HOPPIP
SKIPLOOM=SKIPLOOM
JUMPLUFF=JUMPLUFF
AIPOM=AIPOM
SUNKERN=SUNKERN
SUNFLORA=SUNFLORA
YANMA=YANMA
WOOPER=WOOPER
QUAGSIRE=QUAGSIRE
ESPEON=ESPEON
UMBREON=UMBREON
MURKROW=MURKROW
SLOWKING=SLOWKING
MISDREAVUS=MISDREAVUS
UNOWN=UNOWN
WOBBUFFET=WOBBUFFET
GIRAFARIG=GIRAFARIG
PINECO=PINECO
FORRETRESS=FORRETRESS
DUNSPARCE=DUNSPARCE
GLIGAR=GLIGAR
STEELIX=STEELIX
SNUBBULL=SNUBBULL
GRANBULL=GRANBULL
QWILFISH=QWILFISH
SCIZOR=SCIZOR
SHUCKLE=SHUCKLE
HERACROSS=HERACROSS
SNEASEL=SNEASEL
TEDDIURSA=TEDDIURSA
URSARING=URSARING
SLUGMA=SLUGMA
MAGCARGO=MAGCARGO
SWINUB=SWINUB
PILOSWINE=PILOSWINE
CORSOLA=CORSOLA
REMORAID=REMORAID
OCTILLERY=OCTILLERY
DELIBIRD=DELIBIRD
MANTINE=MANTINE
SKARMORY=SKARMORY
HOUNDOUR=HOUNDOUR
HOUNDOOM=HOUNDOOM
KINGDRA=KINGDRA
PHANPY=PHANPY
DONPHAN=DONPHAN
PORYGON2=PORYGON2
STANTLER=STANTLER
SMEARGLE=SMEARGLE
TYROGUE=TYROGUE
HITMONTOP=HITMONTOP
SMOOCHUM=SMOOCHUM
ELEKID=ELEKID
MAGBY=MAGBY
MILTANK=MILTANK
BLISSEY=BLISSEY
RAIKOU=RAIKOU
ENTEI=ENTEI
SUICUNE=SUICUNE
LARVITAR=LARVITAR
PUPITAR=PUPITAR
TYRANITAR=TYRANITAR
LUGIA=LUGIA
HO-OH=HO_OH
CELEBI=CELEBI
TREECKO=TREECKO
GROVYLE=GROVYLE
SCEPTILE=SCEPTILE
TORCHIC=TORCHIC
COMBUSKEN=COMBUSKEN
BLAZIKEN=BLAZIKEN
MUDKIP=MUDKIP
MARSHTOMP=MARSHTOMP
SWAMPERT=SWAMPERT
POOCHYENA=POOCHYENA
MIGHTYENA=MIGHTYENA
ZIGZAGOON=ZIGZAGOON
LINOONE=LINOONE
WURMPLE=WURMPLE
SILCOON=SILCOON
BEAUTIFLY=BEAUTIFLY
CASCOON=CASCOON
DUSTOX=DUSTOX
LOTAD=LOTAD
LOMBRE=LOMBRE
LUDICOLO=LUDICOLO
SEEDOT=SEEDOT
NUZLEAF=NUZLEAF
SHIFTRY=SHIFTRY
TAILLOW=TAILLOW
SWELLOW=SWELLOW
WINGULL=WINGULL
PELIPPER=PELIPPER
RALTS=RALTS
KIRLIA=KIRLIA
GARDEVOIR=GARDEVOIR
SURSKIT=SURSKIT
MASQUERAIN=MASQUERAIN
SHROOMISH=SHROOMISH
BRELOOM=BRELOOM
SLAKOTH=SLAKOTH
VIGOROTH=VIGOROTH
SLAKING=SLAKING
NINCADA=NINCADA
NINJASK=NINJASK
SHEDINJA=SHEDINJA
WHISMUR=WHISMUR
LOUDRED=LOUDRED
EXPLOUD=EXPLOUD
MAKUHITA=MAKUHITA
HARIYAMA=HARIYAMA
AZURILL=AZURILL
NOSEPASS=NOSEPASS
SKITTY=SKITTY
DELCATTY=DELCATTY
SABLEYE=SABLEYE
MAWILE=MAWILE
ARON=ARON
LAIRON=LAIRON
AGGRON=AGGRON
MEDITITE=MEDITITE
MEDICHAM=MEDICHAM
ELECTRIKE=ELECTRIKE
MANECTRIC=MANECTRIC
PLUSLE=PLUSLE
MINUN=MINUN
VOLBEAT=VOLBEAT
ILLUMISE=ILLUMISE
ROSELIA=ROSELIA
GULPIN=GULPIN
SWALOT=SWALOT
CARVANHA=CARVANHA
SHARPEDO=SHARPEDO
WAILMER=WAILMER
WAILORD=WAILORD
NUMEL=NUMEL
CAMERUPT=CAMERUPT
TORKOAL=TORKOAL
SPOINK=SPOINK
GRUMPIG=GRUMPIG
SPINDA=SPINDA
TRAPINCH=TRAPINCH
VIBRAVA=VIBRAVA
FLYGON=FLYGON
CACNEA=CACNEA
CACTURNE=CACTURNE
SWABLU=SWABLU
ALTARIA=ALTARIA
ZANGOOSE=ZANGOOSE
SEVIPER=SEVIPER
LUNATONE=LUNATONE
SOLROCK=SOLROCK
BARBOACH=BARBOACH
WHISCASH=WHISCASH
CORPHISH=CORPHISH
CRAWDAUNT=CRAWDAUNT
BALTOY=BALTOY
CLAYDOL=CLAYDOL
LILEEP=LILEEP
CRADILY=CRADILY
ANORITH=ANORITH
ARMALDO=ARMALDO
FEEBAS=FEEBAS
MILOTIC=MILOTIC
CASTFORM=CASTFORM
KECLEON=KECLEON
SHUPPET=SHUPPET
BANETTE=BANETTE
DUSKULL=DUSKULL
DUSCLOPS=DUSCLOPS
TROPIUS=TROPIUS
CHIMECHO=CHIMECHO
ABSOL=ABSOL
WYNAUT=WYNAUT
SNORUNT=SNORUNT
GLALIE=GLALIE
SPHEAL=SPHEAL
SEALEO=SEALEO
WALREIN=WALREIN
CLAMPERL=CLAMPERL
HUNTAIL=HUNTAIL
GOREBYSS=GOREBYSS
RELICANTH=RELICANTH
LUVDISC=LUVDISC
BAGON=BAGON
SHELGON=SHELGON
SALAMENCE=SALAMENCE
BELDUM=BELDUM
METANG=METANG
METAGROSS=METAGROSS
REGIROCK=REGIROCK
REGICE=REGICE
REGISTEEL=REGISTEEL
LATIAS=LATIAS
LATIOS=LATIOS
KYOGRE=KYOGRE
GROUDON=GROUDON
RAYQUAZA=RAYQUAZA
JIRACHI=JIRACHI
DEOXYS=DEOXYS