----------=----------
BISASAM=BISASAM
BISAKNOSP=BISAKNOSP
BISAFLOR=BISAFLOR
GLUMANDA=GLUMANDA
GLUTEXO=GLUTEXO
GLURAK=GLURAK
SCHIGGY=SCHIGGY
SCHILLOK=SCHILLOK
TURTOK=TURTOK
RAUPY=RAUPY
SAFCON=SAFCON
SMETTBO=SMETTBO
HORNLIU=HORNLIU
KOKUNA=KOKUNA
BIBOR=BIBOR
TAUBSI=TAUBSI
TAUBOGA=TAUBOGA
TAUBOSS=TAUBOSS
RATTFRATZ=RATTFRATZ
RATTIKARL=RATTIKARL
HABITAK=HABITAK
IBITAK=IBITAK
RETTAN=RETTAN
ARBOK=ARBOK
PIKACHU=PIKACHU
RAICHU=RAICHU
SANDAN=SANDAN
SANDAMER=SANDAMER
NIDORAN♀=NIDORAN_F
NIDORINA=NIDORINA
NIDOQUEEN=NIDOQUEEN
NIDORAN♂=NIDORAN_M
NIDORINO=NIDORINO
NIDOKING=NIDOKING
PIEPI=PIEPI
PIXI=PIXI
VULPIX=VULPIX
VULNONA=VULNONA
PUMMELUFF=PUMMELUFF
KNUDDELUFF=KNUDDELUFF
ZUBAT=ZUBAT
GOLBAT=GOLBAT
MYRAPLA=MYRAPLA
DUFLOR=DUFLOR
GIFLOR=GIFLOR
PARAS=PARAS
PARASEK=PARASEK
BLUZUK=BLUZUK
OMOT=OMOT
DIGDA=DIGDA
DIGDRI=DIGDRI
MAUZI=MAUZI
SNOBILIKAT=SNOBILIKAT
ENTON=ENTON
ENTORON=ENTORON
MENKI=MENKI
RASAFF=RASAFF
FUKANO=FUKANO
ARKANI=ARKANI
QUAPSEL=QUAPSEL
QUAPUTZI=QUAPUTZI
QUAPPO=QUAPPO
ABRA=ABRA
KADABRA=KADABRA
SIMSALA=SIMSALA
MACHOLLO=MACHOLLO
MASCHOCK=MASCHOCK
MACHOMEI=MACHOMEI
KNOFENSA=KNOFENSA
ULTRIGARIA=ULTRIGARIA
SARZENIA=SARZENIA
TENTACHA=TENTACHA
TENTOXA=TENTOXA
KLEINSTEIN=KLEINSTEIN
GEOROK=GEOROK
GEOWAZ=GEOWAZ
PONITA=PONITA
GALLOPA=GALLOPA
FLEGMON=FLEGMON
LAHMUS=LAHMUS
MAGNETILO=MAGNETILO
MAGNETON=MAGNETON
PORENTA=PORENTA
DODU=DODU
DODRI=DODRI
JUROB=JUROB
JUGONG=JUGONG
SLEIMA=SLEIMA
SLEIMOK=SLEIMOK
MUSCHAS=MUSCHAS
AUSTOS=AUSTOS
NEBULAK=NEBULAK
ALPOLLO=ALPOLLO
GENGAR=GENGAR
ONIX=ONIX
TRAUMATO=TRAUMATO
HYPNO=HYPNO
KRABBY=KRABBY
KINGLER=KINGLER
VOLTOBAL=VOLTOBAL
LEKTROBAL=LEKTROBAL
OWEI=OWEI
KOKOWEI=KOKOWEI
TRAGOSSO=TRAGOSSO
KNOGGA=KNOGGA
KICKLEE=KICKLEE
NOCKCHAN=NOCKCHAN
SCHLURP=SCHLURP
SMOGON=SMOGON
SMOGMOG=SMOGMOG
RIHORN=RIHORN
RIZEROS=RIZEROS
CHANEIRA=CHANEIRA
TANGELA=TANGELA
KANGAMA=KANGAMA
SEEPER=SEEPER
SEEMON=SEEMON
GOLDINI=GOLDINI
GOLKING=GOLKING
STERNDU=STERNDU
STARMIE=STARMIE
PANTIMOS=PANTIMOS
SICHLOR=SICHLOR
ROSSANA=ROSSANA
ELEKTEK=ELEKTEK
MAGMAR=MAGMAR
PINSIR=PINSIR
TAUROS=TAUROS
KARPADOR=KARPADOR
GARADOS=GARADOS
LAPRAS=LAPRAS
DITTO=DITTO
EVOLI=EVOLI
AQUANA=AQUANA
BLITZA=BLITZA
FLAMARA=FLAMARA
PORYGON=PORYGON
AMONITAS=AMONITAS
AMOROSO=AMOROSO
KABUTO=KABUTO
KABUTOPS=KABUTOPS
AERODACTYL=AERODACTYL
RELAXO=RELAXO
ARKTOS=ARKTOS
ZAPDOS=ZAPDOS
LAVADOS=LAVADOS
DRATINI=DRATINI
DRAGONIR=DRAGONIR
DRAGORAN=DRAGORAN
MEWTU=MEWTU
MEW=MEW
ENDIVIE=ENDIVIE
LORBLATT=LORBLATT
MEGANIE=MEGANIE
FEURIGEL=FEURIGEL
IGELAVAR=IGELAVAR
TORNUPTO=TORNUPTO
KARNIMANI=KARNIMANI
TYRACROC=TYRACROC
IMPERGATOR=IMPERGATOR
WIESOR=WIESOR
WIESENIOR=WIESENIOR
HOOTHOOT=HOOTHOOT
NOCTUH=NOCTUH
LEDYBA=LEDYBA
LEDIAN=LEDIAN
WEBARAK=WEBARAK
ARIADOS=ARIADOS
IKSBAT=IKSBAT
LAMPI=LAMPI
LANTURN=LANTURN
PICHU=PICHU
PII=PII
FLUFFELUFF=FLUFFELUFF
TOGEPI=TOGEPI
TOGETIC=TOGETIC
NATU=NATU
XATU=XATU
VOLTILAMM=VOLTILAMM
WAATY=WAATY
AMPHAROS=AMPHAROS
BLUBELLA=BLUBELLA
MARILL=MARILL
AZUMARILL=AZUMARILL
MOGELBAUM=MOGELBAUM
QUAXO=QUAXO
HOPPSPROSS=HOPPSPROSS
HUBELUPF=HUBELUPF
PAPUNGHA=PAPUNGHA
GRIFFEL=GRIFFEL
SONNKERN=SONNKERN
SONNFLORA=SONNFLORA
YANMA=YANMA
FELINO=FELINO
MORLORD=MORLORD
PSIANA=PSIANA
NACHTARA=NACHTARA
KRAMURX=KRAMURX
LASCHOKING=LASCHOKING
TRAUNFUGIL=TRAUNFUGIL
ICOGNITO=ICOGNITO
WOINGENAU=WOINGENAU
GIRAFARIG=GIRAFARIG
TANNZA=TANNZA
FORSTELLKA=FORSTELLKA
DUMMISEL=DUMMISEL
SKORGLA=SKORGLA
STAHLOS=STAHLOS
SNUBBULL=SNUBBULL
GRANBULL=GRANBULL
BALDORFISH=BALDORFISH
SCHEROX=SCHEROX
POTTROTT=POTTROTT
SKARABORN=SKARABORN
SNIEBEL=SNIEBEL
TEDDIURSA=TEDDIURSA
URSARING=URSARING
SCHNECKMAG=SCHNECKMAG
MAGCARGO=MAGCARGO
QUIEKEL=QUIEKEL
KEIFEL=KEIFEL
CORASONN=CORASONN
REMORAID=REMORAID
OCTILLERY=OCTILLERY
BOTOGEL=BOTOGEL
MANTAX=MANTAX
PANZAERON=PANZAERON
HUNDUSTER=HUNDUSTER
HUNDEMON=HUNDEMON
SEEDRAKING=SEEDRAKING
PHANPY=PHANPY
DONPHAN=DONPHAN
PORYGON2=PORYGON2
DAMHIRPLEX=DAMHIRPLEX
FARBEAGLE=FARBEAGLE
RABAUZ=RABAUZ
KAPOERA=KAPOERA
KUSSILLA=KUSSILLA
ELEKID=ELEKID
MAGBY=MAGBY
MILTANK=MILTANK
HEITEIRA=HEITEIRA
RAIKOU=RAIKOU
ENTEI=ENTEI
SUICUNE=SUICUNE
LARVITAR=LARVITAR
PUPITAR=PUPITAR
DESPOTAR=DESPOTAR
LUGIA=LUGIA
HO-OH=HO-OH
CELEBI=CELEBI
GECKARBOR=GECKARBOR
REPTAIN=REPTAIN
GEWALDRO=GEWALDRO
FLEMMLI=FLEMMLI
JUNGGLUT=JUNGGLUT
LOHGOCK=LOHGOCK
HYDROPI=HYDROPI
MOORABBEL=MOORABBEL
SUMPEX=SUMPEX
FIFFYEN=FIFFYEN
MAGNAYEN=MAGNAYEN
ZIGZACHS=ZIGZACHS
GERADAKS=GERADAKS
WAUMPEL=WAUMPEL
SCHALOKO=SCHALOKO
PAPINELLA=PAPINELLA
PANEKON=PANEKON
PUDOX=PUDOX
LOTURZEL=LOTURZEL
LOMBRERO=LOMBRERO
KAPPALORES=KAPPALORES
SAMURZEL=SAMURZEL
BLANAS=BLANAS
TENGULIST=TENGULIST
SCHWALBINI=SCHWALBINI
SCHWALBOSS=SCHWALBOSS
WINGULL=WINGULL
PELIPPER=PELIPPER
TRASLA=TRASLA
KIRLIA=KIRLIA
GUARDEVOIR=GUARDEVOIR
GEHWEIHER=GEHWEIHER
MASKEREGEN=MASKEREGEN
KNILZ=KNILZ
KAPILZ=KAPILZ
BUMMELZ=BUMMELZ
MUNTIER=MUNTIER
LETARKING=LETARKING
NINCADA=NINCADA
NINJASK=NINJASK
NINJATOM=NINJATOM
FLURMEL=FLURMEL
KRAKEELO=KRAKEELO
KRAWUMMS=KRAWUMMS
MAKUHITA=MAKUHITA
HARIYAMA=HARIYAMA
AZURILL=AZURILL
NASGNET=NASGNET
ENECO=ENECO
ENEKORO=ENEKORO
ZOBIRIS=ZOBIRIS
FLUNKIFER=FLUNKIFER
STOLLUNIOR=STOLLUNIOR
STOLLRAK=STOLLRAK
STOLLOSS=STOLLOSS
MEDITIE=MEDITIE
MEDITALIS=MEDITALIS
FRIZELBLIZ=FRIZELBLIZ
VOLTENSO=VOLTENSO
PLUSLE=PLUSLE
MINUN=MINUN
VOLBEAT=VOLBEAT
ILLUMISE=ILLUMISE
ROSELIA=ROSELIA
SCHLUPPUCK=SCHLUPPUCK
SCHLUKWECH=SCHLUKWECH
KANIVANHA=KANIVANHA
TOHAIDO=TOHAIDO
WAILMER=WAILMER
WAILORD=WAILORD
CAMAUB=CAMAUB
CAMERUPT=CAMERUPT
QURTEL=QURTEL
SPOINK=SPOINK
GROINK=GROINK
PANDIR=PANDIR
KNACKLION=KNACKLION
VIBRAVA=VIBRAVA
LIBELLDRA=LIBELLDRA
TUSKA=TUSKA
NOKTUSKA=NOKTUSKA
WABLU=WABLU
ALTARIA=ALTARIA
SENGO=SENGO
VIPITIS=VIPITIS
LUNASTEIN=LUNASTEIN
SONNFEL=SONNFEL
SCHMERBE=SCHMERBE
WELSAR=WELSAR
KREBSCORPS=KREBSCORPS
KREBUTACK=KREBUTACK
PUPPANCE=PUPPANCE
LEPUMENTAS=LEPUMENTAS
LILIEP=LILIEP
WIELIE=WIELIE
ANORITH=ANORITH
ARMALDO=ARMALDO
BARSCHWA=BARSCHWA
MILOTIC=MILOTIC
FORMEO=FORMEO
KECLEON=KECLEON
SHUPPET=SHUPPET
BANETTE=BANETTE
ZWIRRLICHT=ZWIRRLICHT
ZWIRRKLOP=ZWIRRKLOP
TROPIUS=TROPIUS
PALIMPALIM=PALIMPALIM
ABSOL=ABSOL
ISSO=ISSO
SCHNEPPKE=SCHNEPPKE
FIRNONTOR=FIRNONTOR
SEEMOPS=SEEMOPS
SEEJONG=SEEJONG
WALRAISA=WALRAISA
PERLU=PERLU
AALABYSS=AALABYSS
SAGANABYSS=SAGANABYSS
RELICANTH=RELICANTH
LIEBISKUS=LIEBISKUS
KINDWURM=KINDWURM
DRASCHEL=DRASCHEL
BRUTALANDA=BRUTALANDA
TANHEL=TANHEL
METANG=METANG
METAGROSS=METAGROSS
REGIROCK=REGIROCK
REGICE=REGICE
REGISTEEL=REGISTEEL
LATIAS=LATIAS
LATIOS=LATIOS
KYOGRE=KYOGRE
GROUDON=GROUDON
RAYQUAZA=RAYQUAZA
JIRACHI=JIRACHI
DEOXYS=DEOXYS